concept_academicfield_aircraft	concept:atdate	concept_date_n1941
concept_academicfield_public_health	concept:academicfieldsuchasacademicfield	concept_academicfield_plant_biology
concept_academicfield_public_health	concept:academicprogramatuniversity	concept_university_harvard_school_of_public_health
concept_academicfield_public_health	concept:academicprogramatuniversity	concept_university_uc_berkeley
concept_actor_financial	concept:agentcompeteswithagent	concept_musicartist_times
concept_agent_vision	concept:objectfoundinscene	concept_landscapefeatures_valley
concept_agriculturalproduct_animals	concept:agriculturalproductgrowninlandscapefeatures	concept_landscapefeatures_valley
concept_agriculturalproduct_animals	concept:agriculturalproductincludingagriculturalproduct	concept_meat_beef
concept_agriculturalproduct_banana	concept:agriculturalproductcutintogeometricshape	concept_geometricshape_cubes
concept_agriculturalproduct_beets	concept:agriculturalproductcutintogeometricshape	concept_geometricshape_cubes
concept_agriculturalproduct_bell_pepper	concept:agriculturalproductcookedwithagriculturalproduct	concept_vegetable_garlic
concept_agriculturalproduct_bell_pepper	concept:agriculturalproductcutintogeometricshape	concept_geometricshape_dice
concept_agriculturalproduct_cake	concept:agriculturalproductcutintogeometricshape	concept_geometricshape_cubes
concept_agriculturalproduct_cake	concept:agriculturalproductcutintogeometricshape	concept_geometricshape_squares
concept_agriculturalproduct_cheeses	concept:agriculturalproductcutintogeometricshape	concept_geometricshape_cubes
concept_agriculturalproduct_chives	concept:agriculturalproductcutintogeometricshape	concept_geometricshape_bits
concept_agriculturalproduct_cucumbers	concept:agriculturalproductcutintogeometricshape	concept_geometricshape_cubes
concept_agriculturalproduct_dough	concept:agriculturalproductcutintogeometricshape	concept_geometricshape_squares
concept_agriculturalproduct_eggplants	concept:agriculturalproductcutintogeometricshape	concept_geometricshape_cubes
concept_agriculturalproduct_grape	concept:agriculturalproductcamefromcountry	concept_country___america
concept_agriculturalproduct_green_pepper	concept:agriculturalproductcutintogeometricshape	concept_geometricshape_dice
concept_agriculturalproduct_herbs	concept:agriculturalproductcutintogeometricshape	concept_geometricshape_cubes
concept_agriculturalproduct_lamb	concept:agriculturalproductcutintogeometricshape	concept_geometricshape_cubes
concept_agriculturalproduct_mango	concept:agriculturalproductcutintogeometricshape	concept_geometricshape_cubes
concept_agriculturalproduct_mozzarella	concept:agriculturalproductcutintogeometricshape	concept_geometricshape_cubes
concept_agriculturalproduct_pear	concept:agriculturalproductcutintogeometricshape	concept_geometricshape_cubes
concept_agriculturalproduct_peel	concept:agriculturalproductcutintogeometricshape	concept_geometricshape_cubes
concept_agriculturalproduct_pineapple	concept:agriculturalproductcutintogeometricshape	concept_geometricshape_cubes
concept_agriculturalproduct_red_pepper	concept:agriculturalproductcutintogeometricshape	concept_geometricshape_dice
concept_agriculturalproduct_root	concept:agriculturalproductcamefromcountry	concept_country___america
concept_agriculturalproduct_salt	concept:agriculturalproductcutintogeometricshape	concept_geometricshape_bits
concept_agriculturalproduct_salt	concept:agriculturalproductcutintogeometricshape	concept_geometricshape_cubes
concept_agriculturalproduct_seed	concept:agriculturalproductcutintogeometricshape	concept_geometricshape_cubes
concept_agriculturalproduct_sides	concept:objectfoundinscene	concept_landscapefeatures_valley
concept_agriculturalproduct_skin	concept:agriculturalproductcutintogeometricshape	concept_geometricshape_cubes
concept_agriculturalproduct_tortillas	concept:agriculturalproductcutintogeometricshape	concept_geometricshape_squares
concept_agriculturalproduct_turnip	concept:agriculturalproductcutintogeometricshape	concept_geometricshape_cubes
concept_agriculturalproduct_water	concept:agriculturalproductcutintogeometricshape	concept_geometricshape_cubes
concept_agriculturalproduct_wildflower	concept:agriculturalproductcamefromcountry	concept_country___america
concept_agriculturalproduct_yams	concept:agriculturalproductcutintogeometricshape	concept_geometricshape_cubes
concept_agriculturalproduct_zucchini	concept:agriculturalproductcutintogeometricshape	concept_geometricshape_cubes
concept_airport_minneapolis	concept:proxyfor	concept_stadiumoreventvenue_target_center
concept_amphibian_figures	concept:agentinvolvedwithitem	concept_buildingfeature_window
concept_amphibian_references	concept:agentinvolvedwithitem	concept_buildingfeature_window
concept_animal_commercial_species	concept:animalsuchasfish	concept_fish_swordfish
concept_animal_commercial_species	concept:animalsuchasfish	concept_fish_tuna
concept_animal_deep_sea_fish	concept:animalsuchasfish	concept_fish_swordfish
concept_animal_fatty_fish	concept:animalsuchasfish	concept_fish_mackerel
concept_animal_fatty_fish	concept:animalsuchasfish	concept_fish_tuna
concept_animal_game_species	concept:animalsuchasfish	concept_fish_marlin
concept_animal_hammerheads	concept:animalistypeofanimal	concept_fish_pelagics
concept_animal_large_predator_fish	concept:animalsuchasfish	concept_fish_swordfish
concept_animal_ocean_fish	concept:animalsuchasfish	concept_fish_tuna
concept_animal_pelagic_species	concept:animalsuchasfish	concept_fish_tuna
concept_animal_pelagic_species	concept:animalsuchasfish	concept_fish_whale_sharks
concept_artery_arteries	concept:bodypartcontainsbodypart	concept_bodypart_system001
concept_artery_brain	concept:bodypartcontainsbodypart	concept_artery_arteries
concept_arthropod_files	concept:agentinvolvedwithitem	concept_buildingfeature_window
concept_arthropod_record	concept:agentinvolvedwithitem	concept_buildingfeature_window
concept_astronaut_landing	concept:agentinvolvedwithitem	concept_buildingfeature_window
concept_athlete_aaron	concept:athleteplayssportsteamposition	concept_sportsteamposition_player
concept_athlete_ahman_green	concept:athleteplayssportsteamposition	concept_sportsteamposition_running_back
concept_athlete_andrea_pirlo	concept:athleteplayssportsteamposition	concept_sportsteamposition_player
concept_athlete_andrew_golota	concept:athleteplayssport	concept_sport_boxing
concept_athlete_antonio_margarito	concept:athleteplayssport	concept_sport_boxing
concept_athlete_antonio_pierce	concept:athletehomestadium	concept_stadiumoreventvenue_giants_stadium
concept_athlete_babe_ruth	concept:athleteplayssportsteamposition	concept_sportsteamposition_player
concept_athlete_bernard_hopkins	concept:athleteplayssport	concept_sport_boxing
concept_athlete_blake	concept:athleteinjuredhisbodypart	concept_bone_shoulder
concept_athlete_brad_ausmus_gg	concept:athleteinjuredhisbodypart	concept_braintissue_eyes
concept_athlete_brees	concept:athleteinjuredhisbodypart	concept_bone_shoulder
concept_athlete_brett_farve	concept:athleteplayssportsteamposition	concept_sportsteamposition_player
concept_athlete_calvin_johnson	concept:athleteplayssportsteamposition	concept_sportsteamposition_player
concept_athlete_carmelo_anthony	concept:athleteplayssportsteamposition	concept_sportsteamposition_player
concept_athlete_charles_brewer	concept:athleteinjuredhisbodypart	concept_bone_shoulder
concept_athlete_chris_davis	concept:athletehomestadium	concept_stadiumoreventvenue_giants_stadium
concept_athlete_chris_drury	concept:athletehomestadium	concept_stadiumoreventvenue_giants_stadium
concept_athlete_colton_orr	concept:athletehomestadium	concept_stadiumoreventvenue_giants_stadium
concept_athlete_corey_dillon	concept:athleteplayssportsteamposition	concept_sportsteamposition_running_back
concept_athlete_cristiano_ronaldo	concept:athleteplayssportsteamposition	concept_sportsteamposition_player
concept_athlete_crosby	concept:athleteplayssportsteamposition	concept_sportsteamposition_player
concept_athlete_curtis_martin	concept:athleteplayssportsteamposition	concept_sportsteamposition_player
concept_athlete_curtis_martin	concept:athleteplayssportsteamposition	concept_sportsteamposition_running_back
concept_athlete_damon	concept:athleteinjuredhisbodypart	concept_braintissue_eyes
concept_athlete_dan_marino	concept:athleteplayssportsteamposition	concept_sportsteamposition_player
concept_athlete_danny_wright	concept:athleteplayssportsteamposition	concept_sportsteamposition_player
concept_athlete_david_murphy	concept:athletehomestadium	concept_stadiumoreventvenue_giants_stadium
concept_athlete_derrick_turnbow	concept:athleteplayssportsteamposition	concept_sportsteamposition_player
concept_athlete_dh	concept:athleteinjuredhisbodypart	concept_braintissue_eyes
concept_athlete_diego_corrales	concept:athleteplayssport	concept_sport_boxing
concept_athlete_domenik_hixon	concept:athletehomestadium	concept_stadiumoreventvenue_giants_stadium
concept_athlete_donovan_mcnabb	concept:athleteplayssportsteamposition	concept_sportsteamposition_player
concept_athlete_dwight_lowery	concept:athletehomestadium	concept_stadiumoreventvenue_giants_stadium
concept_athlete_earnest_byner	concept:athleteplayssportsteamposition	concept_sportsteamposition_running_back
concept_athlete_eddie_basinski	concept:athleteplayssportsteamposition	concept_sportsteamposition_player
concept_athlete_eddie_george	concept:athleteplayssportsteamposition	concept_sportsteamposition_running_back
concept_athlete_edgerrin_james	concept:athleteplayssportsteamposition	concept_sportsteamposition_running_back
concept_athlete_eli_manning	concept:athletebeatathlete	concept_athlete_joe_bradley
concept_athlete_emmitt_smith	concept:athleteplayssportsteamposition	concept_sportsteamposition_player
concept_athlete_eric_dickerson	concept:athleteplayssportsteamposition	concept_sportsteamposition_player
concept_athlete_erik_morales	concept:athleteplayssport	concept_sport_boxing
concept_athlete_farve	concept:athletehomestadium	concept_stadiumoreventvenue_giants_stadium
concept_athlete_favre	concept:athleteplayssportsteamposition	concept_sportsteamposition_player
concept_athlete_felix_trinidad	concept:athleteplayssport	concept_sport_boxing
concept_athlete_floyd_mayweather_jr	concept:athleteplayssport	concept_sport_boxing
concept_athlete_frank	concept:athleteplayssportsteamposition	concept_sportsteamposition_player
concept_athlete_fred_mcgriff	concept:athleteplayssportsteamposition	concept_sportsteamposition_player
concept_athlete_freddie_jones	concept:athleteinjuredhisbodypart	concept_braintissue_eyes
concept_athlete_freddie_jones	concept:athleteplayssportsteamposition	concept_sportsteamposition_player
concept_athlete_freeman_mcneil	concept:athleteplayssportsteamposition	concept_sportsteamposition_running_back
concept_athlete_gardner	concept:athleteplayssportsteamposition	concept_sportsteamposition_player
concept_athlete_hasim_rahman	concept:athleteplayssport	concept_sport_boxing
concept_athlete_henrik_lundqvist	concept:athletehomestadium	concept_stadiumoreventvenue_giants_stadium
concept_athlete_henry	concept:athleteplayssportsteamposition	concept_sportsteamposition_player
concept_athlete_html	concept:agentinvolvedwithitem	concept_buildingfeature_window
concept_athlete_jagr	concept:athletehomestadium	concept_stadiumoreventvenue_giants_stadium
concept_athlete_jameer_nelson	concept:athleteinjuredhisbodypart	concept_bone_shoulder
concept_athlete_jaromir_jagr	concept:athletehomestadium	concept_stadiumoreventvenue_giants_stadium
concept_athlete_jason	concept:athleteplayssportsteamposition	concept_sportsteamposition_player
concept_athlete_jeff_lacy	concept:athleteplayssport	concept_sport_boxing
concept_athlete_jerome_bettis	concept:athleteplayssportsteamposition	concept_sportsteamposition_running_back
concept_athlete_jerricho_cotchery	concept:athletehomestadium	concept_stadiumoreventvenue_giants_stadium
concept_athlete_jerry_rice	concept:athleteplayssportsteamposition	concept_sportsteamposition_player
concept_athlete_jim	concept:persondiedatage	2
concept_athlete_jim_brown	concept:athleteplayssportsteamposition	concept_sportsteamposition_running_back
concept_athlete_jim_courier	concept:athletewinsawardtrophytournament	concept_awardtrophytournament_australian_open
concept_athlete_joe_bradley	concept:athleteplayssportsteamposition	concept_sportsteamposition_player
concept_athlete_joe_calzaghe	concept:athleteplayssport	concept_sport_boxing
concept_athlete_joe_namath	concept:athletehomestadium	concept_stadiumoreventvenue_giants_stadium
concept_athlete_john_ruiz	concept:athleteplayssport	concept_sport_boxing
concept_athlete_jones	concept:athleteinjuredhisbodypart	concept_bodypart_hands
concept_athlete_jose_luis_castillo	concept:athleteplayssport	concept_sport_boxing
concept_athlete_juan_manuel_marquez	concept:athleteplayssport	concept_sport_boxing
concept_athlete_junior	concept:athleteinjuredhisbodypart	concept_braintissue_eyes
concept_athlete_kevin	concept:athleteplayssportsteamposition	concept_sportsteamposition_player
concept_athlete_kurt_warner	concept:athleteplayssportsteamposition	concept_sportsteamposition_player
concept_athlete_lawrence_taylor	concept:athletehomestadium	concept_stadiumoreventvenue_giants_stadium
concept_athlete_lawrence_taylor	concept:athleteplayssportsteamposition	concept_sportsteamposition_player
concept_athlete_lindsay_davenport	concept:athletebeatathlete	concept_athlete_williams
concept_athlete_lindsay_davenport	concept:athleteplayssport	concept_sport_tennis
concept_athlete_lleyton_hewitt	concept:athleteplayssport	concept_sport_tennis
concept_athlete_lt__joseph_r__hunt	concept:athleteinjuredhisbodypart	concept_braintissue_eyes
concept_athlete_luis	concept:athleteinjuredhisbodypart	concept_braintissue_eyes
concept_athlete_lundqvist	concept:athletehomestadium	concept_stadiumoreventvenue_giants_stadium
concept_athlete_mac	concept:agentinvolvedwithitem	concept_buildingfeature_windows
concept_athlete_maradona	concept:athleteplayssportsteamposition	concept_sportsteamposition_player
concept_athlete_marc_staal	concept:athletehomestadium	concept_stadiumoreventvenue_giants_stadium
concept_athlete_marco_antonio_barrera	concept:athleteplayssport	concept_sport_boxing
concept_athlete_markus_naslund	concept:athletehomestadium	concept_stadiumoreventvenue_giants_stadium
concept_athlete_michael_strahan	concept:athletehomestadium	concept_stadiumoreventvenue_giants_stadium
concept_athlete_michael_vick	concept:athleteplayssportsteamposition	concept_sportsteamposition_player
concept_athlete_michael_young	concept:athletehomestadium	concept_stadiumoreventvenue_giants_stadium
concept_athlete_miguel_dilone	concept:athleteinjuredhisbodypart	concept_braintissue_eyes
concept_athlete_mike	concept:athleteplayssportsteamposition	concept_sportsteamposition_player
concept_athlete_mike_richter	concept:athletehomestadium	concept_stadiumoreventvenue_giants_stadium
concept_athlete_mike_vick	concept:athleteplayssportsteamposition	concept_sportsteamposition_player
concept_athlete_mikkel_kessler	concept:athleteplayssport	concept_sport_boxing
concept_athlete_nacho_novo	concept:athletehomestadium	concept_stadiumoreventvenue_giants_stadium
concept_athlete_nigel_dawes	concept:athletehomestadium	concept_stadiumoreventvenue_giants_stadium
concept_athlete_o__j__simpson	concept:athleteplayssportsteamposition	concept_sportsteamposition_player
concept_athlete_oscar_de_la_hoya	concept:athleteplayssport	concept_sport_boxing
concept_athlete_osi_umenyiora	concept:athletehomestadium	concept_stadiumoreventvenue_giants_stadium
concept_athlete_ottis_anderson	concept:athleteplayssportsteamposition	concept_sportsteamposition_running_back
concept_athlete_pat_rafter	concept:athleteplayssport	concept_sport_tennis
concept_athlete_paul_mara	concept:athletehomestadium	concept_stadiumoreventvenue_giants_stadium
concept_athlete_pele	concept:athleteplayssportsteamposition	concept_sportsteamposition_player
concept_athlete_pete_sampras	concept:athletebeatathlete	concept_athlete_michael_chang
concept_athlete_pete_sampras	concept:athletewinsawardtrophytournament	concept_awardtrophytournament_australian_open
concept_athlete_petr_prucha	concept:athletehomestadium	concept_stadiumoreventvenue_giants_stadium
concept_athlete_plaxico	concept:athletehomestadium	concept_stadiumoreventvenue_giants_stadium
concept_athlete_randy	concept:athleteplayssportsteamposition	concept_sportsteamposition_player
concept_athlete_randy_foye	concept:athletehomestadium	concept_stadiumoreventvenue_target_center
concept_athlete_ray_allen	concept:athleteinjuredhisbodypart	concept_braintissue_eyes
concept_athlete_reggie_bush	concept:athleteplayssportsteamposition	concept_sportsteamposition_player
concept_athlete_rich_aurilia	concept:athletehomestadium	concept_stadiumoreventvenue_giants_stadium
concept_athlete_ricky_jean_francois	concept:athleteplayssportsteamposition	concept_sportsteamposition_player
concept_athlete_ricky_watters	concept:athleteplayssportsteamposition	concept_sportsteamposition_running_back
concept_athlete_roger_craig	concept:athleteplayssportsteamposition	concept_sportsteamposition_running_back
concept_athlete_ryan_callahan	concept:athletehomestadium	concept_stadiumoreventvenue_giants_stadium
concept_athlete_scott	concept:athleteinjuredhisbodypart	concept_bone_shoulder
concept_athlete_scott_gomez_and_chris_drury	concept:athletehomestadium	concept_stadiumoreventvenue_giants_stadium
concept_athlete_sean_taylor	concept:athleteplayssportsteamposition	concept_sportsteamposition_player
concept_athlete_shane_mosley	concept:athleteplayssport	concept_sport_boxing
concept_athlete_shawntae_spencer	concept:athleteinjuredhisbodypart	concept_braintissue_eyes
concept_athlete_stefan_frei	concept:athletehomestadium	concept_stadiumoreventvenue_giants_stadium
concept_athlete_steve	concept:athleteplayssportsteamposition	concept_sportsteamposition_player
concept_athlete_steve_nash	concept:athleteplayssportsteamposition	concept_sportsteamposition_player
concept_athlete_sugar_ray_leonard	concept:athleteplayssport	concept_sport_boxing
concept_athlete_tiki_barber	concept:athletehomestadium	concept_stadiumoreventvenue_giants_stadium
concept_athlete_tim_tebow	concept:athleteplayssportsteamposition	concept_sportsteamposition_player
concept_athlete_tony_dorsett	concept:athleteplayssportsteamposition	concept_sportsteamposition_running_back
concept_athlete_troy_o_leary	concept:athleteplayssportsteamposition	concept_sportsteamposition_player
concept_athlete_vernon_forrest	concept:athleteplayssport	concept_sport_boxing
concept_athlete_wallace	concept:athleteplayssportsteamposition	concept_sportsteamposition_player
concept_athlete_walter_payton	concept:athleteplayssportsteamposition	concept_sportsteamposition_player
concept_athlete_williams	concept:athleteinjuredhisbodypart	concept_bone_shoulder
concept_athlete_willis	concept:athleteplayssportsteamposition	concept_sportsteamposition_player
concept_athlete_zach_thomas	concept:athleteinjuredhisbodypart	concept_bone_shoulder
concept_attraction_end	concept:objectfoundinscene	concept_landscapefeatures_valley
concept_attraction_grand	concept:riveremptiesintoriver	concept_geopoliticallocation_yosemite
concept_attraction_grand	concept:riveremptiesintoriver	concept_river_colorado_river
concept_attraction_grand	concept:riveremptiesintoriver	concept_river_green_river
concept_attraction_grand	concept:riveremptiesintoriver	concept_river_lake_michigan
concept_attraction_grand	concept:riveremptiesintoriver	concept_river_lee
concept_attraction_grand	concept:riveremptiesintoriver	concept_river_yellowstone
concept_attraction_grand	concept:riveremptiesintoriver	concept_river_zion
concept_attraction_grand	concept:riveremptiesintoriver	concept_skiarea_red_cedar_river
concept_attraction_grand	concept:riveremptiesintoriver	concept_skiarea_snake_river
concept_attraction_mississippi	concept:riveremptiesintoriver	concept_river_great_river_road
concept_attraction_mississippi	concept:riveremptiesintoriver	concept_river_industrial_canal
concept_attraction_mississippi	concept:riveremptiesintoriver	concept_river_intracoastal_waterway
concept_attraction_mississippi	concept:riveremptiesintoriver	concept_river_minnesota_river
concept_attraction_mississippi	concept:riveremptiesintoriver	concept_river_ohio_river
concept_attraction_mississippi	concept:riveremptiesintoriver	concept_river_pacific_coast
concept_attraction_mississippi	concept:riveremptiesintoriver	concept_river_rock_river
concept_attraction_mississippi	concept:riveremptiesintoriver	concept_river_st___croix_river
concept_attraction_mississippi	concept:riveremptiesintoriver	concept_river_st___lawrence_river
concept_attraction_mississippi	concept:riveremptiesintoriver	concept_river_tennessee_river
concept_attraction_mississippi	concept:riveremptiesintoriver	concept_river_yazoo_river
concept_attraction_mouth	concept:objectfoundinscene	concept_landscapefeatures_valley
concept_automobilemaker_abarth	concept:automobilemakerdealersincountry	concept_country_uk
concept_automobilemaker_acura	concept:automobilemakercardealersinstateorprovince	concept_stateorprovince_virginia
concept_automobilemaker_audi	concept:automobilemakerdealersincity	concept_city_san_diego
concept_automobilemaker_audi	concept:hasofficeincountry	concept_country_uk__canada
concept_automobilemaker_bolivia	concept:agentbelongstoorganization	concept_sportsleague_mls
concept_automobilemaker_buick	concept:automakerproducesmodel	concept_automobilemodel_buick_century
concept_automobilemaker_buick	concept:automakerproducesmodel	concept_automobilemodel_buick_rainier
concept_automobilemaker_buick	concept:automakerproducesmodel	concept_automobilemodel_buick_regal
concept_automobilemaker_buick	concept:automakerproducesmodel	concept_automobilemodel_buick_rendezvous
concept_automobilemaker_buick	concept:automakerproducesmodel	concept_automobilemodel_regal
concept_automobilemaker_buick	concept:automakerproducesmodel	concept_automobilemodel_riviera
concept_automobilemaker_buick	concept:automobilemakerdealersincity	concept_city_columbus
concept_automobilemaker_chevrolet	concept:automobilemakerdealersincity	concept_city_baton_rouge
concept_automobilemaker_chevrolet	concept:hasofficeincountry	concept_country_uk
concept_automobilemaker_chrysler	concept:automobilemakerdealersincountry	concept_country_uk
concept_automobilemaker_ferrari	concept:subpartoforganization	concept_automobilemaker_fiat_spa
concept_automobilemaker_fiat	concept:acquired	concept_automobilemaker_ferrari
concept_automobilemaker_fiat	concept:companyeconomicsector	concept_economicsector_auto
concept_automobilemaker_ford	concept:automakerproducesmodel	concept_automobilemodel_edge
concept_automobilemaker_ford	concept:automobilemakerdealersincountry	concept_country_uk
concept_automobilemaker_gm	concept:acquired	concept_automobilemaker_gmc
concept_automobilemaker_gm	concept:acquired	concept_automobilemaker_vauxhall
concept_automobilemaker_honda	concept:agentcreated	concept_automobilemodel_toyota_corolla
concept_automobilemaker_honda	concept:agentcreated	concept_automobilemodel_toyota_prius
concept_automobilemaker_honda	concept:agentcreated	concept_charactertrait_insight
concept_automobilemaker_honda	concept:agentcreated	concept_city_fit
concept_automobilemaker_honda	concept:agentcreated	concept_city_prelude
concept_automobilemaker_honda	concept:agentinvolvedwithitem	concept_automobilemodel_ford_mustang
concept_automobilemaker_honda	concept:agentinvolvedwithitem	concept_automobilemodel_honda_fit
concept_automobilemaker_honda	concept:agentinvolvedwithitem	concept_automobilemodel_nissan_altima
concept_automobilemaker_honda	concept:agentinvolvedwithitem	concept_buildingfeature_fit
concept_automobilemaker_honda	concept:agentinvolvedwithitem	concept_hallwayitem_van
concept_automobilemaker_honda	concept:automakerproducesmodel	concept_automobilemodel_accord
concept_automobilemaker_honda	concept:automakerproducesmodel	concept_automobilemodel_accord_crosstour
concept_automobilemaker_honda	concept:automakerproducesmodel	concept_automobilemodel_civic_coupe
concept_automobilemaker_honda	concept:automakerproducesmodel	concept_automobilemodel_civic_hybrid
concept_automobilemaker_honda	concept:automakerproducesmodel	concept_automobilemodel_civic_si
concept_automobilemaker_honda	concept:automakerproducesmodel	concept_automobilemodel_cr_v
concept_automobilemaker_honda	concept:automakerproducesmodel	concept_automobilemodel_honda_civic
concept_automobilemaker_honda	concept:automakerproducesmodel	concept_automobilemodel_honda_cr_v
concept_automobilemaker_honda	concept:automakerproducesmodel	concept_automobilemodel_honda_odyssey
concept_automobilemaker_honda	concept:automakerproducesmodel	concept_automobilemodel_passport
concept_automobilemaker_honda	concept:automakerproducesmodel	concept_automobilemodel_ridgeline
concept_automobilemaker_honda	concept:automakerproducesmodel	concept_product_crv
concept_automobilemaker_honda	concept:automakerproducesmodel	concept_product_element
concept_automobilemaker_honda	concept:automakerproducesmodel	concept_product_insight
concept_automobilemaker_honda	concept:automobilemakercardealersinstateorprovince	concept_stateorprovince_alabama
concept_automobilemaker_honda	concept:automobilemakercardealersinstateorprovince	concept_stateorprovince_maryland
concept_automobilemaker_honda	concept:automobilemakercardealersinstateorprovince	concept_stateorprovince_oklahoma
concept_automobilemaker_honda	concept:automobilemakerdealersincity	concept_city_albuquerque
concept_automobilemaker_honda	concept:automobilemakerdealersincity	concept_city_athens
concept_automobilemaker_honda	concept:automobilemakerdealersincity	concept_city_bakersfield
concept_automobilemaker_honda	concept:automobilemakerdealersincity	concept_city_fort_worth
concept_automobilemaker_honda	concept:automobilemakerdealersincity	concept_city_houston
concept_automobilemaker_honda	concept:automobilemakerdealersincity	concept_city_huntsville
concept_automobilemaker_honda	concept:automobilemakerdealersincity	concept_city_minneapolis
concept_automobilemaker_honda	concept:automobilemakerdealersincity	concept_city_sacramento
concept_automobilemaker_honda	concept:automobilemakerdealersincity	concept_city_santa_monica
concept_automobilemaker_honda	concept:automobilemakerdealersincity	concept_city_seattle
concept_automobilemaker_honda	concept:automobilemakerdealersincity	concept_city_tulsa
concept_automobilemaker_honda	concept:automobilemakerdealersincity	concept_city_wilmington
concept_automobilemaker_honda	concept:automobilemakerdealersincountry	concept_country_uk
concept_automobilemaker_honda	concept:companyeconomicsector	concept_economicsector_auto
concept_automobilemaker_honda	concept:competeswith	concept_automobilemaker_toyota
concept_automobilemaker_honda	concept:organizationterminatedperson	concept_ceo_takeo_fukui
concept_automobilemaker_honda	concept:producesproduct	concept_automobilemodel_honda_accord
concept_automobilemaker_honda	concept:producesproduct	concept_automobilemodel_odyssey
concept_automobilemaker_honda	concept:producesproduct	concept_product_prelude
concept_automobilemaker_hummer	concept:hasofficeincountry	concept_country_uk
concept_automobilemaker_infiniti	concept:automobilemakercardealersinstateorprovince	concept_stateorprovince_virginia
concept_automobilemaker_jeep	concept:automobilemakerdealersincity	concept_city_charleston
concept_automobilemaker_jeep	concept:automobilemakerdealersincity	concept_city_vancouver
concept_automobilemaker_jeep	concept:hasofficeincountry	concept_country_uk
concept_automobilemaker_jeep	concept:subpartoforganization	concept_automobilemaker_daimlerchrysler
concept_automobilemaker_lancia	concept:hasofficeincountry	concept_country_uk
concept_automobilemaker_land_rover	concept:hasofficeincountry	concept_country_uk
concept_automobilemaker_landrover	concept:automobilemakerdealersincountry	concept_country_uk
concept_automobilemaker_lincoln	concept:automobilemakercardealersinstateorprovince	concept_stateorprovince_virginia
concept_automobilemaker_listing	concept:agentinvolvedwithitem	concept_buildingfeature_window
concept_automobilemaker_maserati	concept:automobilemakerdealersincountry	concept_country___america
concept_automobilemaker_mazda	concept:automobilemakerdealersincountry	concept_country_uk
concept_automobilemaker_mercedes_benz	concept:automobilemakercardealersinstateorprovince	concept_stateorprovince_virginia
concept_automobilemaker_mini	concept:hasofficeincountry	concept_country_uk
concept_automobilemaker_mitsubishi	concept:agentinvolvedwithitem	concept_buildingfeature_eclipse
concept_automobilemaker_mitsubishi	concept:automakerproducesmodel	concept_automobilemodel_colt
concept_automobilemaker_mitsubishi	concept:automakerproducesmodel	concept_automobilemodel_eclipse
concept_automobilemaker_mitsubishi	concept:automakerproducesmodel	concept_automobilemodel_mitsubishi_eclipse
concept_automobilemaker_mitsubishi	concept:automakerproducesmodel	concept_visualizableobject_lancer
concept_automobilemaker_mitsubishi	concept:hasofficeincountry	concept_country_uk
concept_automobilemaker_money	concept:subpartoforganization	concept_terroristorganization_state
concept_automobilemaker_nafta	concept:hasofficeincountry	concept_country___america
concept_automobilemaker_pagani	concept:automobilemakerdealersincountry	concept_country_uk
concept_automobilemaker_partners	concept:subpartoforganization	concept_terroristorganization_state
concept_automobilemaker_porsche	concept:automobilemakerdealersincountry	concept_country_uk
concept_automobilemaker_proton	concept:hasofficeincountry	concept_country_uk
concept_automobilemaker_request	concept:agentinvolvedwithitem	concept_buildingfeature_window
concept_automobilemaker_skoda	concept:hasofficeincountry	concept_country_uk
concept_automobilemaker_smart	concept:automobilemakerdealersincountry	concept_country_uk
concept_automobilemaker_subaru	concept:automakerproducesmodel	concept_automobilemodel_forester
concept_automobilemaker_subaru	concept:automakerproducesmodel	concept_automobilemodel_subaru_forester
concept_automobilemaker_subaru	concept:automakerproducesmodel	concept_automobilemodel_subaru_impreza
concept_automobilemaker_subaru	concept:automakerproducesmodel	concept_automobilemodel_subaru_legacy
concept_automobilemaker_subaru	concept:automakerproducesmodel	concept_automobilemodel_svx
concept_automobilemaker_subaru	concept:automakerproducesmodel	concept_automobilemodel_wrx
concept_automobilemaker_subaru	concept:hasofficeincountry	concept_country_uk__canada
concept_automobilemaker_subaru	concept:producesproduct	concept_automobilemodel_legacy
concept_automobilemaker_suzuki	concept:automobilemakercardealersinstateorprovince	concept_stateorprovince_virginia
concept_automobilemaker_vauxhall	concept:automobilemakerdealersincountry	concept_country_uk
concept_automobilemaker_view	concept:agentinvolvedwithitem	concept_buildingfeature_window
concept_automobilemaker_volkswagen	concept:automobilemakercardealersinstateorprovince	concept_stateorprovince_virginia
concept_automobilemaker_volvo	concept:automobilemakercardealersinstateorprovince	concept_stateorprovince_virginia
concept_automobilemaker_volvo	concept:automobilemakerdealersincountry	concept_country___america
concept_automobilemodel_edge	concept:objectfoundinscene	concept_landscapefeatures_valley
concept_automobilemodel_gateway	concept:objectfoundinscene	concept_landscapefeatures_valley
concept_automobilemodel_svx	concept:latitudelongitude	56.7431100000000,60.8027300000000
concept_awardtrophytournament_australian_open	concept:awardtrophytournamentisthechampionshipgameofthenationalsport	concept_sport_tennis
concept_awardtrophytournament_championships	concept:awardtrophytournamentisthechampionshipgameofthenationalsport	concept_sport_diving
concept_awardtrophytournament_championships	concept:awardtrophytournamentisthechampionshipgameofthenationalsport	concept_sport_lacrosse
concept_awardtrophytournament_championships	concept:awardtrophytournamentisthechampionshipgameofthenationalsport	concept_sport_soccer
concept_awardtrophytournament_french_open	concept:awardtrophytournamentisthechampionshipgameofthenationalsport	concept_sport_tennis
concept_awardtrophytournament_state_championship	concept:awardtrophytournamentisthechampionshipgameofthenationalsport	concept_sport_soccer
concept_awardtrophytournament_state_championships	concept:awardtrophytournamentisthechampionshipgameofthenationalsport	concept_sport_soccer
concept_awardtrophytournament_women	concept:awardtrophytournamentisthechampionshipgameofthenationalsport	concept_sport_soccer
concept_bacteria_bacillus_cereus	concept:bacteriaisthecausativeagentofphysiologicalcondition	concept_disease_food_poisoning
concept_bacteria_clostridium_botulinum	concept:bacteriaisthecausativeagentofphysiologicalcondition	concept_disease_food_poisoning
concept_bacteria_e__coli	concept:bacteriaisthecausativeagentofphysiologicalcondition	concept_disease_food_poisoning
concept_bacteria_listeria	concept:bacteriaisthecausativeagentofphysiologicalcondition	concept_disease_food_poisoning
concept_bacteria_salmonella	concept:bacteriaisthecausativeagentofphysiologicalcondition	concept_disease_food_poisoning
concept_bacteria_salmonella_typhimurium	concept:bacteriaisthecausativeagentofphysiologicalcondition	concept_disease_food_poisoning
concept_bank_administration	concept:agentcontrols	concept_clothing_white
concept_bank_barclays	concept:acquired	concept_organization_lehman
concept_bank_barclays	concept:bankbankincountry	concept_country___america
concept_bank_chase_manhattan	concept:bankbankincountry	concept_country___america
concept_bank_chase_manhattan	concept:companyeconomicsector	concept_economicsector_investment
concept_bank_citi	concept:bankbankincountry	concept_country_uk
concept_bank_citibank	concept:bankbankincountry	concept_country_malaysia
concept_bank_citibank	concept:companyeconomicsector	concept_economicsector_banking
concept_bank_citicorp	concept:hasofficeincountry	concept_country___america
concept_bank_commonwealth	concept:hasofficeincountry	concept_country___america
concept_bank_first_national_bank	concept:companyeconomicsector	concept_economicsector_banking
concept_bank_hsbc	concept:bankbankincountry	concept_country_oman
concept_bank_j_p__morgan_chase	concept:companyeconomicsector	concept_economicsector_investment
concept_bank_j_p__morgan_securities	concept:bankbankincountry	concept_country___america
concept_bank_jp_morgan	concept:hasofficeincountry	concept_country___america
concept_bank_lehman_brothers	concept:companyeconomicsector	concept_economicsector_large_investment
concept_bank_lehman_brothers	concept:companyeconomicsector	concept_economicsector_us_investment
concept_bank_lehman_brothers	concept:subpartoforganization	concept_bank_barclays_global_investors
concept_bank_lloyds_tsb	concept:bankbankincountry	concept_country_uk
concept_bank_national	concept:bankbankincountry	concept_country___america
concept_bank_national	concept:bankbankincountry	concept_country_new_south_wales
concept_bank_national	concept:bankboughtbank	concept_bank_abu_dhabi_commercial_bank
concept_bank_national	concept:bankboughtbank	concept_bank_agricultural
concept_bank_national	concept:bankboughtbank	concept_bank_ahli_united_bank
concept_bank_national	concept:bankboughtbank	concept_bank_barclays_capital
concept_bank_national	concept:bankboughtbank	concept_bank_barclays_global_investors
concept_bank_national	concept:bankboughtbank	concept_bank_deutsche_bank
concept_bank_national	concept:bankboughtbank	concept_bank_export_import_bank_of_india
concept_bank_national	concept:bankboughtbank	concept_bank_fidelity_national
concept_bank_national	concept:bankboughtbank	concept_bank_first_leasing_company_of_india
concept_bank_national	concept:bankboughtbank	concept_bank_franklin_templeton
concept_bank_national	concept:bankboughtbank	concept_bank_hang_seng
concept_bank_national	concept:bankboughtbank	concept_bank_hdfc
concept_bank_national	concept:bankboughtbank	concept_bank_hdfc_bank
concept_bank_national	concept:bankboughtbank	concept_bank_icici_bank
concept_bank_national	concept:bankboughtbank	concept_bank_indusind_bank_limited
concept_bank_national	concept:bankboughtbank	concept_bank_ing_vysya
concept_bank_national	concept:bankboughtbank	concept_bank_ing_vysya_bank
concept_bank_national	concept:bankboughtbank	concept_bank_karnataka_bank_ltd
concept_bank_national	concept:bankboughtbank	concept_bank_punjab_and_maharashtra_co_operative_bank_ltd
concept_bank_national	concept:bankboughtbank	concept_bank_punjab_national_bank
concept_bank_national	concept:bankboughtbank	concept_bank_standard_bank
concept_bank_national	concept:bankboughtbank	concept_bank_state_bank_of_saurashtra
concept_bank_national	concept:bankboughtbank	concept_bank_syndicate_bank
concept_bank_national	concept:bankboughtbank	concept_bank_td
concept_bank_national	concept:bankboughtbank	concept_bank_td_ameritrade
concept_bank_national	concept:bankboughtbank	concept_bank_treasury
concept_bank_national	concept:bankboughtbank	concept_bank_uti
concept_bank_national	concept:bankboughtbank	concept_bank_vijaya_bank
concept_bank_northern_rock	concept:bankbankincountry	concept_country_uk
concept_bank_policy_makers	concept:subpartoforganization	concept_terroristorganization_state
concept_bathroomitem_closet	concept:itemfoundinroom	concept_visualizablething_bedrooms
concept_bathroomitem_closet	concept:itemfoundinroom	concept_visualizablething_large_master_bedroom
concept_bathroomitem_shower_room	concept:itemfoundinroom	concept_visualizablething_bedrooms
concept_bedroomitem_pillow	concept:itemfoundinroom	concept_visualizablething_bedrooms
concept_beverage_features	concept:objectfoundinscene	concept_landscapefeatures_valley
concept_beverage_gelatin	concept:agriculturalproductcutintogeometricshape	concept_geometricshape_cubes
concept_beverage_side	concept:objectfoundinscene	concept_landscapefeatures_valley
concept_beverage_tomato_juice	concept:agriculturalproductcutintogeometricshape	concept_geometricshape_cubes
concept_beverage_vineyards	concept:objectfoundinscene	concept_landscapefeatures_valley
concept_beverage_wine_region	concept:objectfoundinscene	concept_landscapefeatures_valley
concept_biotechcompany_control	concept:agentinvolvedwithitem	concept_buildingfeature_window
concept_biotechcompany_left	concept:agentinvolvedwithitem	concept_buildingfeature_window
concept_biotechcompany_portugal	concept:hasofficeincountry	concept_country___america
concept_biotechcompany_toronto	concept:proxyfor	concept_company_canada
concept_bird_condor	concept:agentactsinlocation	concept_city_madrid
concept_bird_may	concept:atdate	concept_date_community
concept_blog_george_w__bush	concept:agentcollaborateswithagent	concept_criminal_gore
concept_blog_george_w__bush	concept:agentcollaborateswithagent	concept_geopoliticallocation_kerry
concept_blog_george_w__bush	concept:agentcontrols	concept_clothing_white
concept_blog_george_w__bush	concept:agentcreated	concept_book_decision_points
concept_blog_kfyr_tv	concept:subpartof	concept_retailstore_nbc
concept_blog_komu_tv	concept:subpartof	concept_retailstore_nbc
concept_blog_ksnf	concept:subpartof	concept_retailstore_nbc
concept_blog_wjac_tv	concept:subpartof	concept_retailstore_nbc
concept_boardgame_civil_war	concept:atdate	concept_year_n1865
concept_bodypart_system002	concept:bodypartcontainsbodypart	concept_braintissue_eyes
concept_bodypart_tract001	concept:bodypartcontainsbodypart	concept_braintissue_eyes
concept_book_fall	concept:atdate	concept_date_meeting
concept_book_one_day	concept:atdate	concept_date_n1941
concept_braintissue_eyes	concept:bodypartcontainsbodypart	concept_artery_brain
concept_building_jackson	concept:buildinglocatedincity	concept_city_port_moresby
concept_buildingfeature_closets	concept:itemfoundinroom	concept_officebuildingroom_large_bedrooms
concept_buildingfeature_closets	concept:itemfoundinroom	concept_visualizablething_bedrooms
concept_buildingfeature_systems	concept:subpartof	concept_visualizableobject_home
concept_buildingfeature_windows	concept:synonymfor	concept_museum_microsoft_corporation
concept_candy_value	concept:objectfoundinscene	concept_landscapefeatures_valley
concept_celebrity_aung_san_suu_kyi	concept:personhasjobposition	concept_jobposition_leader
concept_celebrity_illustration	concept:agentinvolvedwithitem	concept_buildingfeature_window
concept_celebrity_screen	concept:agentinvolvedwithitem	concept_buildingfeature_window
concept_celebrity_show	concept:agentinvolvedwithitem	concept_buildingfeature_window
concept_celebrity_spring	concept:atdate	concept_date_meeting
concept_ceo_blogs	concept:agentinvolvedwithitem	concept_buildingfeature_window
concept_ceo_dick_fuld	concept:ceoof	concept_bank_lehman_brothers
concept_ceo_dick_fuld	concept:personleadsorganization	concept_organization_lehman
concept_ceo_home_page_this_page	concept:agentcollaborateswithagent	concept_musicartist_times
concept_ceo_merrill	concept:agentbelongstoorganization	concept_country___america
concept_ceo_randall_l__stephenson	concept:topmemberoforganization	concept_company_at_t
concept_ceo_webpage	concept:agentinvolvedwithitem	concept_buildingfeature_window
concept_charactertrait_fighting	concept:atdate	concept_date_n1944
concept_charactertrait_military_service	concept:atdate	concept_date_n1941
concept_charactertrait_return	concept:atdate	concept_year_n1919
concept_cheese_suffolk	concept:subpartof	concept_company_new_york
concept_chef_format	concept:agentinvolvedwithitem	concept_buildingfeature_window
concept_city_abidjan	concept:citycapitalofcountry	concept_country_ivory_coast
concept_city_abingdon	concept:atlocation	concept_stateorprovince_virginia
concept_city_abuja	concept:proxyfor	concept_country_nigeria
concept_city_akron	concept:citylocatedinstate	concept_stateorprovince_ohio
concept_city_alicante	concept:citylocatedingeopoliticallocation	concept_country_spain
concept_city_alliance	concept:atlocation	concept_stateorprovince_ohio
concept_city_anoka	concept:cityliesonriver	concept_attraction_mississippi
concept_city_army	concept:atdate	concept_date_n1941
concept_city_army	concept:atdate	concept_year_n1919
concept_city_ashland	concept:atlocation	concept_stateorprovince_virginia
concept_city_auckland	concept:citylocatedingeopoliticallocation	concept_country_papua_new_guinea
concept_city_avon_lake	concept:citylocatedinstate	concept_stateorprovince_ohio
concept_city_azerbaijan	concept:citycapitalofcountry	concept_country_azerbaijan
concept_city_beckley	concept:proxyfor	concept_stateorprovince_west_virginia
concept_city_bellingham	concept:citylocatedinstate	concept_visualizablescene_washington
concept_city_berea	concept:citylocatedinstate	concept_stateorprovince_ohio
concept_city_bermuda	concept:agentbelongstoorganization	concept_sportsleague_mls
concept_city_blue_springs	concept:proxyfor	concept_company_missouri
concept_city_bratislava	concept:proxyfor	concept_country_slovakia
concept_city_brazzaville	concept:citylocatedincountry	concept_country_democratic_republic_of_congo
concept_city_brooklyn	concept:subpartof	concept_county_york_city
concept_city_butler	concept:citylocatedinstate	concept_stateorprovince_ohio
concept_city_caledonia	concept:cityliesonriver	concept_attraction_grand
concept_city_cambridge	concept:proxyfor	concept_stateorprovince_ohio
concept_city_camdenton	concept:proxyfor	concept_company_missouri
concept_city_campbell	concept:citylocatedinstate	concept_stateorprovince_virginia
concept_city_canton	concept:locationlocatedwithinlocation	concept_stateorprovince_ohio
concept_city_capreol	concept:citylocatedinstate	concept_stateorprovince_ontario
concept_city_chantilly	concept:proxyfor	concept_stateorprovince_virginia
concept_city_chardon	concept:atlocation	concept_stateorprovince_ohio
concept_city_charleston	concept:cityliesonriver	concept_attraction_mississippi
concept_city_chatham_kent	concept:proxyfor	concept_stateorprovince_ontario
concept_city_chesapeake	concept:proxyfor	concept_stateorprovince_virginia
concept_city_chillicothe	concept:proxyfor	concept_company_missouri
concept_city_cleveland_heights	concept:citylocatedinstate	concept_stateorprovince_ohio
concept_city_cobourg	concept:citylocatedinstate	concept_stateorprovince_ontario
concept_city_columbia	concept:cityalsoknownas	concept_city_district
concept_city_columbia	concept:cityalsoknownas	concept_city_toronto
concept_city_columbia	concept:locationlocatedwithinlocation	concept_stateorprovince_virginia
concept_city_columbus_ohio	concept:citylocatedinstate	concept_stateorprovince_ohio
concept_city_commerce	concept:cityliesonriver	concept_attraction_mississippi
concept_city_communities	concept:subpartoforganization	concept_terroristorganization_state
concept_city_comstock_park	concept:cityliesonriver	concept_attraction_grand
concept_city_contents	concept:agentinvolvedwithitem	concept_buildingfeature_window
concept_city_costa_rica	concept:agentbelongstoorganization	concept_sportsleague_mls
concept_city_crookston	concept:cityliesonriver	concept_attraction_grand
concept_city_demonstration	concept:agentinvolvedwithitem	concept_buildingfeature_window
concept_city_dexter	concept:proxyfor	concept_company_missouri
concept_city_discussion	concept:agentinvolvedwithitem	concept_buildingfeature_window
concept_city_download	concept:agentinvolvedwithitem	concept_buildingfeature_window
concept_city_dublin_dublin	concept:citylocatedingeopoliticallocation	concept_country_republic
concept_city_duncan	concept:proxyfor	concept_stateorprovince_oklahoma
concept_city_edinburgh	concept:proxyfor	concept_country_scotland
concept_city_erie	concept:citylocatedinstate	concept_stateorprovince_ohio
concept_city_eskilstuna	concept:citylocatedincountry	concept_country_sweden
concept_city_fayette	concept:proxyfor	concept_company_missouri
concept_city_flagstaff	concept:cityliesonriver	concept_attraction_grand
concept_city_flint	concept:cityliesonriver	concept_attraction_grand
concept_city_fort_madison	concept:cityliesonriver	concept_attraction_mississippi
concept_city_fremont	concept:atlocation	concept_stateorprovince_ohio
concept_city_fremont	concept:locationlocatedwithinlocation	concept_city_vegas
concept_city_friedman	concept:agentcollaborateswithagent	concept_musicartist_times
concept_city_front_royal	concept:atlocation	concept_stateorprovince_virginia
concept_city_fukuoka	concept:cityliesonriver	concept_attraction_grand
concept_city_geneva	concept:cityliesonriver	concept_river_rhone
concept_city_grafton	concept:cityliesonriver	concept_attraction_mississippi
concept_city_grand_haven	concept:cityliesonriver	concept_attraction_grand
concept_city_greater_cleveland	concept:citylocatedinstate	concept_stateorprovince_ohio
concept_city_greenville	concept:cityliesonriver	concept_attraction_mississippi
concept_city_greenwood	concept:cityliesonriver	concept_attraction_mississippi
concept_city_grenada	concept:agentbelongstoorganization	concept_sportsleague_mls
concept_city_guatemala_city	concept:agentbelongstoorganization	concept_sportsleague_mls
concept_city_guyana	concept:agentbelongstoorganization	concept_sportsleague_mls
concept_city_hannibal	concept:proxyfor	concept_company_missouri
concept_city_hardy	concept:citylocatedinstate	concept_stateorprovince_west_virginia
concept_city_hastings	concept:cityliesonriver	concept_attraction_mississippi
concept_city_hong_kong_island	concept:cityliesonriver	concept_attraction_grand
concept_city_hornepayne	concept:citylocatedinstate	concept_stateorprovince_ontario
concept_city_hornepayne	concept:latitudelongitude	49.2035425000000,-84.7883400000000
concept_city_huntington	concept:atlocation	concept_stateorprovince_west_virginia
concept_city_hurricane	concept:proxyfor	concept_stateorprovince_west_virginia
concept_city_itasca	concept:cityliesonriver	concept_attraction_mississippi
concept_city_jackson	concept:cityliesonriver	concept_attraction_grand
concept_city_jamaica	concept:agentbelongstoorganization	concept_sportsleague_mls
concept_city_kano	concept:locationlocatedwithinlocation	concept_country_nigeria
concept_city_kiruna	concept:citylocatedincountry	concept_country_sweden
concept_city_lake_city	concept:citylocatedinstate	concept_stateorprovince_florida
concept_city_lancaster	concept:atlocation	concept_stateorprovince_ohio
concept_city_lees_summit	concept:proxyfor	concept_company_missouri
concept_city_lewisburg	concept:proxyfor	concept_stateorprovince_west_virginia
concept_city_lima	concept:atlocation	concept_stateorprovince_ohio
concept_city_lima	concept:citycapitalofcountry	concept_country_peru
concept_city_listings	concept:agentinvolvedwithitem	concept_buildingfeature_window
concept_city_lorain	concept:atlocation	concept_stateorprovince_ohio
concept_city_losuia	concept:citylocatedincountry	concept_country_papua_new_guinea
concept_city_lunenburg	concept:citylocatedinstate	concept_stateorprovince_virginia
concept_city_lyon	concept:cityliesonriver	concept_river_rh_ne
concept_city_lyon	concept:cityliesonriver	concept_river_rhone
concept_city_madrid	concept:citycapitalofcountry	concept_country_spain
concept_city_malaga	concept:citylocatedingeopoliticallocation	concept_country_spain
concept_city_manila	concept:proxyfor	concept_country_philippines
concept_city_marietta	concept:atlocation	concept_stateorprovince_ohio
concept_city_marion	concept:atlocation	concept_stateorprovince_ohio
concept_city_martinsburg	concept:atlocation	concept_stateorprovince_west_virginia
concept_city_martinsville	concept:subpartof	concept_stateorprovince_virginia
concept_city_marysville	concept:proxyfor	concept_stateorprovince_ohio
concept_city_maryville	concept:citylocatedinstate	concept_stateorprovince_northwest_missouri
concept_city_maryville	concept:proxyfor	concept_company_missouri
concept_city_mason	concept:atlocation	concept_stateorprovince_ohio
concept_city_melbourne	concept:citylocatedinstate	concept_stateorprovince_florida
concept_city_miamisburg	concept:atlocation	concept_stateorprovince_ohio
concept_city_middletown	concept:atlocation	concept_stateorprovince_ohio
concept_city_milford	concept:atlocation	concept_stateorprovince_ohio
concept_city_milford	concept:proxyfor	concept_stateorprovince_connecticut
concept_city_minneapolis	concept:proxyfor	concept_attraction_first_avenue
concept_city_mississauga	concept:proxyfor	concept_stateorprovince_ontario
concept_city_moundsville	concept:proxyfor	concept_stateorprovince_west_virginia
concept_city_muscatine	concept:cityliesonriver	concept_attraction_mississippi
concept_city_nassau	concept:citycapitalofcountry	concept_country_bahamas
concept_city_nassau	concept:proxyfor	concept_geopoliticalorganization_the_bahamas
concept_city_nauvoo	concept:cityliesonriver	concept_attraction_mississippi
concept_city_nebraska	concept:cityliesonriver	concept_attraction_grand
concept_city_newark	concept:atlocation	concept_stateorprovince_ohio
concept_city_nouakchott	concept:citylocatedincountry	concept_country_mauritania
concept_city_osage_beach	concept:proxyfor	concept_company_missouri
concept_city_outlook	concept:mutualproxyfor	concept_university_microsoft
concept_city_ozark	concept:atlocation	concept_stateorprovince_alabama
concept_city_painesville	concept:cityliesonriver	concept_attraction_grand
concept_city_parkersburg	concept:locationlocatedwithinlocation	concept_stateorprovince_west_virginia
concept_city_pendleton	concept:citylocatedinstate	concept_stateorprovince_west_virginia
concept_city_pictures	concept:agentinvolvedwithitem	concept_buildingfeature_window
concept_city_poplar_bluff	concept:proxyfor	concept_company_missouri
concept_city_port_hudson	concept:cityliesonriver	concept_attraction_mississippi
concept_city_port_moresby	concept:atdate	concept_date_n1942
concept_city_port_moresby	concept:citylocatedingeopoliticallocation	concept_country_papua_new_guinea
concept_city_portage	concept:citylocatedinstate	concept_stateorprovince_ohio
concept_city_portland	concept:cityliesonriver	concept_attraction_grand
concept_city_preston	concept:citylocatedinstate	concept_stateorprovince_west_virginia
concept_city_quito	concept:citylocatedingeopoliticallocation	concept_country_equador
concept_city_randolph	concept:citylocatedinstate	concept_stateorprovince_west_virginia
concept_city_red_wing	concept:cityliesonriver	concept_attraction_mississippi
concept_city_reston	concept:proxyfor	concept_stateorprovince_virginia
concept_city_reynoldsburg	concept:subpartof	concept_stateorprovince_ohio
concept_city_rock_island	concept:cityliesonriver	concept_attraction_mississippi
concept_city_ronneby	concept:citylocatedincountry	concept_country_sweden
concept_city_saint_joseph	concept:proxyfor	concept_company_missouri
concept_city_saint_louis	concept:cityliesonriver	concept_attraction_mississippi
concept_city_salem	concept:mutualproxyfor	concept_stateorprovince_virginia
concept_city_sandusky	concept:atlocation	concept_stateorprovince_ohio
concept_city_sao_paulo	concept:cityliesonriver	concept_attraction_grand
concept_city_seattle	concept:citylocatedinstate	concept_visualizablescene_washington
concept_city_sedona	concept:cityliesonriver	concept_attraction_grand
concept_city_seneca	concept:citylocatedinstate	concept_stateorprovince_ohio
concept_city_seoul	concept:cityliesonriver	concept_attraction_grand
concept_city_seoul	concept:citylocatedincountry	concept_country_republic
concept_city_sigtuna	concept:citylocatedincountry	concept_country_sweden
concept_city_sources	concept:agentinvolvedwithitem	concept_buildingfeature_window
concept_city_spring	concept:citylocatedinstate	concept_stateorprovince_virginia
concept_city_st___cloud	concept:cityliesonriver	concept_attraction_grand
concept_city_st_paul	concept:cityliesonriver	concept_attraction_mississippi
concept_city_steubenville	concept:proxyfor	concept_stateorprovince_ohio
concept_city_summit	concept:citylocatedinstate	concept_stateorprovince_ohio
concept_city_sveg	concept:citylocatedincountry	concept_country_sweden
concept_city_thief_river_falls	concept:cityliesonriver	concept_attraction_grand
concept_city_tokyo	concept:cityliesonriver	concept_attraction_grand
concept_city_toronto	concept:citylocatedinstate	concept_stateorprovince_ontario
concept_city_valencia	concept:citylocatedincountry	concept_country_spain
concept_city_videos	concept:agentinvolvedwithitem	concept_buildingfeature_window
concept_city_wapakoneta	concept:citylocatedingeopoliticallocation	concept_stateorprovince_ohio
concept_city_warren	concept:cityliesonriver	concept_attraction_grand
concept_city_warren	concept:proxyfor	concept_creditunion_michigan
concept_city_warrensburg	concept:proxyfor	concept_company_missouri
concept_city_warsaw	concept:proxyfor	concept_country_poland
concept_city_waterloo	concept:proxyfor	concept_stateorprovince_ontario
concept_city_wawa	concept:citylocatedinstate	concept_stateorprovince_ontario
concept_city_weirton	concept:proxyfor	concept_stateorprovince_west_virginia
concept_city_west_plains	concept:proxyfor	concept_company_missouri
concept_city_westlake	concept:atlocation	concept_stateorprovince_ohio
concept_city_wheeling	concept:proxyfor	concept_stateorprovince_west_virginia
concept_city_winfield	concept:cityliesonriver	concept_attraction_mississippi
concept_city_winnipeg	concept:cityliesonriver	concept_attraction_grand
concept_city_woodbridge	concept:proxyfor	concept_stateorprovince_virginia
concept_city_zouerate	concept:citylocatedincountry	concept_country_mauritania
concept_clothing_belt	concept:clothingtogowithclothing	concept_clothing_jacket
concept_clothing_belt	concept:clothingtogowithclothing	concept_visualizableobject_shirt
concept_clothing_belt	concept:objectfoundinscene	concept_landscapefeatures_valley
concept_clothing_black_tie	concept:clothingtogowithclothing	concept_visualizableobject_shirt
concept_clothing_blue_jeans	concept:clothingtogowithclothing	concept_clothing_jacket
concept_clothing_blue_suit	concept:clothingtogowithclothing	concept_visualizableobject_shirt
concept_clothing_cloak	concept:clothingtogowithclothing	concept_clothing_hat
concept_clothing_clothes	concept:clothingtogowithclothing	concept_clothing_shirts
concept_clothing_dress	concept:clothingtogowithclothing	concept_visualizableobject_shirt
concept_clothing_dress_shoes	concept:clothingtogowithclothing	concept_visualizableobject_shirt
concept_clothing_gloves	concept:clothingtogowithclothing	concept_visualizableobject_shirt
concept_clothing_gym_pants	concept:clothingtogowithclothing	concept_visualizableobject_shirt
concept_clothing_hat	concept:clothingtogowithclothing	concept_clothing_brown_suit
concept_clothing_hat	concept:clothingtogowithclothing	concept_clothing_leather_coat
concept_clothing_hat	concept:clothingtogowithclothing	concept_clothing_pinstripe_suit
concept_clothing_hat	concept:clothingtogowithclothing	concept_clothing_sun_glasses
concept_clothing_hat	concept:clothingtogowithclothing	concept_clothing_trenchcoat
concept_clothing_hat	concept:clothingtogowithclothing	concept_visualizableobject_shirt
concept_clothing_heels	concept:clothingtogowithclothing	concept_visualizableobject_shirt
concept_clothing_jacket	concept:clothingtogowithclothing	concept_clothing_blouse
concept_clothing_jacket	concept:clothingtogowithclothing	concept_clothing_sweat_pants
concept_clothing_jacket	concept:clothingtogowithclothing	concept_clothing_sweatshirt
concept_clothing_jacket	concept:clothingtogowithclothing	concept_clothing_tee
concept_clothing_jacket	concept:clothingtogowithclothing	concept_clothing_tie
concept_clothing_jacket	concept:clothingtogowithclothing	concept_clothing_vest
concept_clothing_jogging_pants	concept:clothingtogowithclothing	concept_visualizableobject_shirt
concept_clothing_long_black_coat	concept:clothingtogowithclothing	concept_clothing_hat
concept_clothing_long_coat	concept:clothingtogowithclothing	concept_clothing_hat
concept_clothing_long_pants	concept:clothingtogowithclothing	concept_clothing_jacket
concept_clothing_navy_shorts	concept:clothingtogowithclothing	concept_visualizableobject_shirt
concept_clothing_overcoat	concept:clothingtogowithclothing	concept_clothing_hat
concept_clothing_protective_clothing	concept:clothingtogowithclothing	concept_clothing_hat
concept_clothing_raincoat	concept:clothingtogowithclothing	concept_visualizableobject_shirt
concept_clothing_robes	concept:clothingmadefromplant	concept_plant_bamboo
concept_clothing_robes	concept:itemfoundinroom	concept_visualizablething_bedrooms
concept_clothing_shirts	concept:clothingtogowithclothing	concept_clothing_jacket
concept_clothing_shirts	concept:clothingtogowithclothing	concept_clothing_long_sleeves
concept_clothing_shirts	concept:clothingtogowithclothing	concept_clothing_socks
concept_clothing_shirts	concept:clothingtogowithclothing	concept_clothing_underwear
concept_clothing_skirt	concept:clothingtogowithclothing	concept_clothing_jacket
concept_clothing_stockings	concept:clothingtogowithclothing	concept_clothing_hat
concept_clothing_tie	concept:clothingtogowithclothing	concept_clothing_white_suit
concept_clothing_trousers	concept:clothingtogowithclothing	concept_clothing_jacket
concept_clothing_tshirt	concept:clothingtogowithclothing	concept_visualizableobject_shirt
concept_clothing_white_shirt	concept:clothingtogowithclothing	concept_clothing_jacket
concept_clothing_white_shorts	concept:clothingtogowithclothing	concept_visualizableobject_shirt
concept_clothing_white_socks	concept:clothingtogowithclothing	concept_visualizableobject_shirt
concept_clothing_wig	concept:clothingtogowithclothing	concept_clothing_hat
concept_coach_brandon_dubinsky	concept:athletehomestadium	concept_stadiumoreventvenue_giants_stadium
concept_coach_daunte_culpepper	concept:athleteplayssportsteamposition	concept_sportsteamposition_player
concept_coach_fredrik_sjostrom	concept:athletehomestadium	concept_stadiumoreventvenue_giants_stadium
concept_coach_jay_feely	concept:athletehomestadium	concept_stadiumoreventvenue_giants_stadium
concept_coach_key	concept:agentinvolvedwithitem	concept_buildingfeature_window
concept_coach_ladainian_tomlinson	concept:athleteplayssportsteamposition	concept_sportsteamposition_running_back
concept_coach_lebron_james	concept:athleteplayssportsteamposition	concept_sportsteamposition_player
concept_coach_lenny_moore	concept:athleteplayssportsteamposition	concept_sportsteamposition_running_back
concept_coach_marshall_faulk	concept:athleteplayssportsteamposition	concept_sportsteamposition_running_back
concept_coach_new_york_red_bulls	concept:agentbelongstoorganization	concept_sportsleague_mls
concept_coach_nikolai_zherdev	concept:athletehomestadium	concept_stadiumoreventvenue_giants_stadium
concept_coach_occupation	concept:atdate	concept_date_n1941
concept_coach_peter_moylan	concept:athleteplayssportsteamposition	concept_sportsteamposition_player
concept_coach_zidane	concept:athleteplayssportsteamposition	concept_sportsteamposition_player
concept_comedian_john_chancellor	concept:subpartof	concept_retailstore_nbc
concept_comedian_richard	concept:persondiedatage	2
concept_company_access	concept:subpartoforganization	concept_company_adobe
concept_company_adobe	concept:agentcreated	concept_mlalgorithm_microsoft_word
concept_company_adobe	concept:agentcreated	concept_product_word_documents
concept_company_adobe	concept:agentcreated	concept_website_download
concept_company_adobe	concept:agentinvolvedwithitem	concept_buildingfeature_window
concept_company_adobe	concept:agentinvolvedwithitem	concept_consumerelectronicitem_ms_word
concept_company_adobe	concept:agentinvolvedwithitem	concept_product_powerpoint
concept_company_air_niugini	concept:organizationheadquarteredincity	concept_city_port_moresby
concept_company_arizona	concept:companyeconomicsector	concept_economicsector_insurance_coverage
concept_company_at_t	concept:acquired	concept_company_bellsouth
concept_company_at_t	concept:companyeconomicsector	concept_economicsector_telecoms
concept_company_at_t	concept:hasofficeincity	concept_city_middletown
concept_company_at_t	concept:organizationterminatedperson	concept_ceo_c__michael_armstrong
concept_company_at_t	concept:organizationterminatedperson	concept_ceo_randall_l__stephenson
concept_company_at_t	concept:organizationterminatedperson	concept_person_ed_whitacre
concept_company_at_t	concept:subpartoforganization	concept_company_sprint_nextel
concept_company_bahamas_air	concept:headquarteredin	concept_city_nassau
concept_company_bahamasair	concept:hasofficeincity	concept_city_nassau
concept_company_canada	concept:companyeconomicsector	concept_economicsector_insurance
concept_company_canada	concept:hasofficeincountry	concept_country___america
concept_company_companies	concept:companyeconomicsector	concept_economicsector_insurance
concept_company_delta	concept:acquired	concept_company_northwest_airlines
concept_company_delta	concept:hasofficeincity	concept_city_las_vegas
concept_company_dialog	concept:agentinvolvedwithitem	concept_buildingfeature_window
concept_company_easyjet	concept:hasofficeincity	concept_city_belfast
concept_company_easyjet	concept:hasofficeincity	concept_city_edinburgh
concept_company_easyjet	concept:hasofficeincity	concept_city_geneva
concept_company_firefly	concept:subpartoforganization	concept_university_microsoft
concept_company_flybe	concept:acquired	concept_company_ba_connect
concept_company_flybe	concept:hasofficeincity	concept_city_bergerac
concept_company_flybe	concept:hasofficeincity	concept_city_brest
concept_company_general	concept:hasofficeincountry	concept_country_scotland
concept_company_general_mills	concept:organizationheadquarteredincity	concept_city_minneapolis
concept_company_general_mills001	concept:agentcollaborateswithagent	concept_magazine_pillsbury
concept_company_general_mills001	concept:headquarteredin	concept_city_minneapolis
concept_company_general_motors	concept:companyeconomicsector	concept_economicsector_auto
concept_company_general_motors	concept:competeswith	concept_company_chrysler
concept_company_iran	concept:hasofficeincountry	concept_country___america
concept_company_japan	concept:atdate	concept_date_n1941
concept_company_missouri	concept:atdate	concept_date_n1864
concept_company_missouri	concept:mutualproxyfor	concept_city_rolla
concept_company_missouri	concept:mutualproxyfor	concept_room_saint_charles
concept_company_missouri	concept:mutualproxyfor	concept_sociopolitical_independence
concept_company_missouri	concept:mutualproxyfor	concept_televisionstation_saint_louis
concept_company_missouri	concept:mutualproxyfor	concept_visualizablescene_joplin
concept_company_missouri	concept:organizationterminatedperson	concept_personaustralia_gary_pinkel
concept_company_missouri	concept:organizationterminatedperson	concept_personmexico_mike_anderson
concept_company_missouri	concept:organizationterminatedperson	concept_personus_norm_stewart
concept_company_msn_search	concept:agentcompeteswithagent	concept_university_search
concept_company_netherlands	concept:hasofficeincountry	concept_country___america
concept_company_new_york	concept:agentcompeteswithagent	concept_musicartist_times
concept_company_new_york	concept:companyeconomicsector	concept_economicsector_insurance_coverage
concept_company_new_york	concept:competeswith	concept_company_yahoo001
concept_company_new_york	concept:competeswith	concept_politicsblog_tribune
concept_company_new_york	concept:competeswith	concept_politicsblog_village_voice
concept_company_new_york	concept:competeswith	concept_televisionstation_los_angeles_times
concept_company_northwest_airlines	concept:hasofficeincity	concept_city_amsterdam
concept_company_northwest_airlines	concept:hasofficeincity	concept_city_manila
concept_company_pbs	concept:acquired	concept_company_kues
concept_company_pbs	concept:agentcontrols	concept_televisionstation_kaet
concept_company_pbs	concept:agentcontrols	concept_televisionstation_kaft
concept_company_pbs	concept:agentcontrols	concept_televisionstation_kawe
concept_company_pbs	concept:agentcontrols	concept_televisionstation_kbhe_tv
concept_company_pbs	concept:agentcontrols	concept_televisionstation_kbme_tv
concept_company_pbs	concept:agentcontrols	concept_televisionstation_kbtc_tv
concept_company_pbs	concept:agentcontrols	concept_televisionstation_kcge_dt
concept_company_pbs	concept:agentcontrols	concept_televisionstation_kcos_tv
concept_company_pbs	concept:agentcontrols	concept_televisionstation_kdck
concept_company_pbs	concept:agentcontrols	concept_televisionstation_kesd_tv
concept_company_pbs	concept:agentcontrols	concept_televisionstation_kisu_tv
concept_company_pbs	concept:agentcontrols	concept_televisionstation_klpb_tv
concept_company_pbs	concept:agentcontrols	concept_televisionstation_klru
concept_company_pbs	concept:agentcontrols	concept_televisionstation_kmbh_tv
concept_company_pbs	concept:agentcontrols	concept_televisionstation_kmos_tv
concept_company_pbs	concept:agentcontrols	concept_televisionstation_kocv_tv
concept_company_pbs	concept:agentcontrols	concept_televisionstation_kood
concept_company_pbs	concept:agentcontrols	concept_televisionstation_kozk
concept_company_pbs	concept:agentcontrols	concept_televisionstation_kpsd_tv
concept_company_pbs	concept:agentcontrols	concept_televisionstation_kpts
concept_company_pbs	concept:agentcontrols	concept_televisionstation_krcb
concept_company_pbs	concept:agentcontrols	concept_televisionstation_krne_tv
concept_company_pbs	concept:agentcontrols	concept_televisionstation_krsc_tv
concept_company_pbs	concept:agentcontrols	concept_televisionstation_krwg_tv
concept_company_pbs	concept:agentcontrols	concept_televisionstation_kswk
concept_company_pbs	concept:agentcontrols	concept_televisionstation_ktci_tv
concept_company_pbs	concept:agentcontrols	concept_televisionstation_ktnw
concept_company_pbs	concept:agentcontrols	concept_televisionstation_ktsc_tv
concept_company_pbs	concept:agentcontrols	concept_televisionstation_kuas_tv
concept_company_pbs	concept:agentcontrols	concept_televisionstation_kuat_tv
concept_company_pbs	concept:agentcontrols	concept_televisionstation_kued
concept_company_pbs	concept:agentcontrols	concept_televisionstation_kufm_tv
concept_company_pbs	concept:agentcontrols	concept_televisionstation_kuon_tv
concept_company_pbs	concept:agentcontrols	concept_televisionstation_kusm
concept_company_pbs	concept:agentcontrols	concept_televisionstation_kxne_tv
concept_company_pbs	concept:agentcontrols	concept_televisionstation_kyne_tv
concept_company_pbs	concept:agentcontrols	concept_televisionstation_wbcc_tv
concept_company_pbs	concept:agentcontrols	concept_televisionstation_wbiq_tv
concept_company_pbs	concept:agentcontrols	concept_televisionstation_wcfe_tv
concept_company_pbs	concept:agentcontrols	concept_televisionstation_wetp_tv
concept_company_pbs	concept:agentcontrols	concept_televisionstation_wfpt
concept_company_pbs	concept:agentcontrols	concept_televisionstation_wfsu_tv
concept_company_pbs	concept:agentcontrols	concept_televisionstation_wgbx_tv
concept_company_pbs	concept:agentcontrols	concept_televisionstation_wgby_tv
concept_company_pbs	concept:agentcontrols	concept_televisionstation_wgcu_tv
concept_company_pbs	concept:agentcontrols	concept_televisionstation_wgpt
concept_company_pbs	concept:agentcontrols	concept_televisionstation_wgte_tv
concept_company_pbs	concept:agentcontrols	concept_televisionstation_wha__tv
concept_company_pbs	concept:agentcontrols	concept_televisionstation_whla_tv
concept_company_pbs	concept:agentcontrols	concept_televisionstation_whro_tv
concept_company_pbs	concept:agentcontrols	concept_televisionstation_wiiq
concept_company_pbs	concept:agentcontrols	concept_televisionstation_wkha
concept_company_pbs	concept:agentcontrols	concept_televisionstation_wkle
concept_company_pbs	concept:agentcontrols	concept_televisionstation_wkma
concept_company_pbs	concept:agentcontrols	concept_televisionstation_wkmu
concept_company_pbs	concept:agentcontrols	concept_televisionstation_wkno_tv
concept_company_pbs	concept:agentcontrols	concept_televisionstation_wkop_tv
concept_company_pbs	concept:agentcontrols	concept_televisionstation_wkpi
concept_company_pbs	concept:agentcontrols	concept_televisionstation_wkso_tv
concept_company_pbs	concept:agentcontrols	concept_televisionstation_wkyu_tv
concept_company_pbs	concept:agentcontrols	concept_televisionstation_wkzt_tv
concept_company_pbs	concept:agentcontrols	concept_televisionstation_wlef_tv
concept_company_pbs	concept:agentcontrols	concept_televisionstation_wlpb_tv
concept_company_pbs	concept:agentcontrols	concept_televisionstation_wlvt_tv
concept_company_pbs	concept:agentcontrols	concept_televisionstation_wmed_tv
concept_company_pbs	concept:agentcontrols	concept_televisionstation_wmfe_tv
concept_company_pbs	concept:agentcontrols	concept_televisionstation_wmpn_tv
concept_company_pbs	concept:agentcontrols	concept_televisionstation_wmpt
concept_company_pbs	concept:agentcontrols	concept_televisionstation_wmvs_tv
concept_company_pbs	concept:agentcontrols	concept_televisionstation_wneo
concept_company_pbs	concept:agentcontrols	concept_televisionstation_wnin_tv
concept_company_pbs	concept:agentcontrols	concept_televisionstation_wnit_tv
concept_company_pbs	concept:agentcontrols	concept_televisionstation_wnjn
concept_company_pbs	concept:agentcontrols	concept_televisionstation_wnsc_tv
concept_company_pbs	concept:agentcontrols	concept_televisionstation_wosu_tv
concept_company_pbs	concept:agentcontrols	concept_televisionstation_wpba
concept_company_pbs	concept:agentcontrols	concept_televisionstation_wpbo_tv
concept_company_pbs	concept:agentcontrols	concept_televisionstation_wpby_tv
concept_company_pbs	concept:agentcontrols	concept_televisionstation_wpto
concept_company_pbs	concept:agentcontrols	concept_televisionstation_wqec
concept_company_pbs	concept:agentcontrols	concept_televisionstation_wqpt_tv
concept_company_pbs	concept:agentcontrols	concept_televisionstation_wsbn_tv
concept_company_pbs	concept:agentcontrols	concept_televisionstation_wsre
concept_company_pbs	concept:agentcontrols	concept_televisionstation_wtiu_tv
concept_company_pbs	concept:agentcontrols	concept_televisionstation_wunc_tv
concept_company_pbs	concept:agentcontrols	concept_televisionstation_wund_tv
concept_company_pbs	concept:agentcontrols	concept_televisionstation_wunm_tv
concept_company_pbs	concept:agentcontrols	concept_televisionstation_wunp_tv
concept_company_pbs	concept:agentcontrols	concept_televisionstation_wvta
concept_company_pbs	concept:agentcontrols	concept_televisionstation_wxxi_tv
concept_company_ryanair	concept:hasofficeincity	concept_city_aberdeen
concept_company_ryanair	concept:hasofficeincity	concept_city_ancona
concept_company_ryanair	concept:hasofficeincity	concept_city_billund
concept_company_ryanair	concept:hasofficeincity	concept_city_bologna
concept_company_ryanair	concept:hasofficeincity	concept_city_bremen
concept_company_ryanair	concept:hasofficeincity	concept_city_brest
concept_company_ryanair	concept:hasofficeincity	concept_city_brindisi
concept_company_ryanair	concept:hasofficeincity	concept_city_edinburgh
concept_company_ryanair	concept:hasofficeincity	concept_city_frankfurt
concept_company_ryanair	concept:hasofficeincity	concept_city_friedrichshafen
concept_company_ryanair	concept:hasofficeincity	concept_city_gothenburg
concept_company_ryanair	concept:hasofficeincity	concept_city_granada
concept_company_ryanair	concept:hasofficeincity	concept_city_graz
concept_company_ryanair	concept:hasofficeincity	concept_city_hamburg
concept_company_ryanair	concept:hasofficeincity	concept_city_milan
concept_company_ryanair	concept:hasofficeincity	concept_city_montpellier
concept_company_ryanair	concept:hasofficeincity	concept_city_pisa
concept_company_ryanair	concept:hasofficeincity	concept_city_seville
concept_company_ryanair	concept:hasofficeincity	concept_city_tampere
concept_company_ryanair	concept:hasofficeincity	concept_geopoliticallocation_santander
concept_company_ryanair	concept:hasofficeincity	concept_geopoliticallocation_zadar
concept_company_ryanair	concept:hasofficeincity	concept_visualizablething_biarritz
concept_company_ryanair	concept:headquarteredin	concept_city_glasgow
concept_company_sbc_communications_inc_	concept:acquired	concept_company_at_t
concept_company_services	concept:agentinvolvedwithitem	concept_buildingfeature_windows
concept_company_services	concept:organizationalsoknownas	concept_sportsleague_field
concept_company_stories	concept:agentinvolvedwithitem	concept_buildingfeature_window
concept_company_subaru_of_america	concept:organizationacronymhasname	concept_automobilemaker_subaru
concept_company_target	concept:hasofficeincity	concept_city_minneapolis
concept_company_user	concept:agentinvolvedwithitem	concept_buildingfeature_window
concept_company_village_voice_media	concept:agentcontrols	concept_journalist_james_ridgeway
concept_company_village_voice_media	concept:agentcontrols	concept_musician_nat_hentoff
concept_company_wikipedia	concept:competeswith	concept_company_yahoo001
concept_company_wipo	concept:headquarteredin	concept_city_geneva
concept_company_world_meteorological_organization	concept:headquarteredin	concept_city_geneva
concept_company_wto001	concept:headquarteredin	concept_city_geneva
concept_company_yahoo001	concept:acquired	concept_website_inktomi
concept_country___america	concept:countryalsoknownas	concept_country_australasia
concept_country___america	concept:organizationhiredperson	concept_personnorthamerica_kenneth_d__lewis
concept_country_african_republic	concept:countryalsoknownas	concept_country_democratic_republic_of_congo
concept_country_arabia_saudita	concept:countrylocatedingeopoliticallocation	concept_geopoliticallocation_middle_east
concept_country_bric	concept:countrylocatedingeopoliticallocation	concept_country_countries
concept_country_brunei	concept:countrylocatedingeopoliticallocation	concept_continent_asia
concept_country_burma	concept:countrylocatedingeopoliticallocation	concept_country_countries
concept_country_cayman_islands	concept:countrylocatedingeopoliticallocation	concept_country_countries
concept_country_democratic_republic_of_congo	concept:countryalsoknownas	concept_country_republic_of_benin
concept_country_democratic_republic_of_congo	concept:countryalsoknownas	concept_country_south_sudan
concept_country_djibouti	concept:countrylocatedingeopoliticallocation	concept_continent_africa
concept_country_equador	concept:countrylocatedingeopoliticallocation	concept_country_countries
concept_country_eu_member_states	concept:countrylocatedingeopoliticallocation	concept_country_countries
concept_country_gambia	concept:agentbelongstoorganization	concept_sportsleague_mls
concept_country_hungary	concept:countrylocatedingeopoliticallocation	concept_country_eastern_european_countries
concept_country_israel	concept:atdate	concept_month_september
concept_country_kuwait	concept:countrylocatedingeopoliticallocation	concept_country_countries
concept_country_laos	concept:countrylocatedingeopoliticallocation	concept_continent_asia
concept_country_luxemburg	concept:countrylocatedingeopoliticallocation	concept_country_countries
concept_country_malaya	concept:countrylocatedingeopoliticallocation	concept_country_countries
concept_country_maldives	concept:countrylocatedingeopoliticallocation	concept_country_countries
concept_country_peru	concept:countryalsoknownas	concept_country_republic
concept_country_peru	concept:countrylocatedingeopoliticallocation	concept_geopoliticallocation_destinations
concept_country_philippines	concept:countrylocatedingeopoliticallocation	concept_continent_asia
concept_country_poland	concept:atdate	concept_date_n1941
concept_country_republic	concept:countryalsoknownas	concept_country___america
concept_country_republic	concept:countryalsoknownas	concept_country_albania
concept_country_republic	concept:countryalsoknownas	concept_country_algeria
concept_country_republic	concept:countryalsoknownas	concept_country_arabia_saudita
concept_country_republic	concept:countryalsoknownas	concept_country_armenia
concept_country_republic	concept:countryalsoknownas	concept_country_aruba
concept_country_republic	concept:countryalsoknownas	concept_country_azerbaijan
concept_country_republic	concept:countryalsoknownas	concept_country_bahamas
concept_country_republic	concept:countryalsoknownas	concept_country_barbados
concept_country_republic	concept:countryalsoknownas	concept_country_bulgaria
concept_country_republic	concept:countryalsoknownas	concept_country_burkina
concept_country_republic	concept:countryalsoknownas	concept_country_burundi
concept_country_republic	concept:countryalsoknownas	concept_country_cameroon
concept_country_republic	concept:countryalsoknownas	concept_country_central_african_republic
concept_country_republic	concept:countryalsoknownas	concept_country_comoros
concept_country_republic	concept:countryalsoknownas	concept_country_costa_rica
concept_country_republic	concept:countryalsoknownas	concept_country_cuba
concept_country_republic	concept:countryalsoknownas	concept_country_cyprus
concept_country_republic	concept:countryalsoknownas	concept_country_darfur
concept_country_republic	concept:countryalsoknownas	concept_country_darfur_region
concept_country_republic	concept:countryalsoknownas	concept_country_democratic_republic_of_congo
concept_country_republic	concept:countryalsoknownas	concept_country_djibouti
concept_country_republic	concept:countryalsoknownas	concept_country_drc
concept_country_republic	concept:countryalsoknownas	concept_country_el_salvador
concept_country_republic	concept:countryalsoknownas	concept_country_equator__guinea
concept_country_republic	concept:countryalsoknownas	concept_country_ethiopia
concept_country_republic	concept:countryalsoknownas	concept_country_former_soviet_union
concept_country_republic	concept:countryalsoknownas	concept_country_gabon
concept_country_republic	concept:countryalsoknownas	concept_country_gambia
concept_country_republic	concept:countryalsoknownas	concept_country_ghana
concept_country_republic	concept:countryalsoknownas	concept_country_guyana
concept_country_republic	concept:countryalsoknownas	concept_country_hungary
concept_country_republic	concept:countryalsoknownas	concept_country_iran
concept_country_republic	concept:countryalsoknownas	concept_country_ireland
concept_country_republic	concept:countryalsoknownas	concept_country_israel
concept_country_republic	concept:countryalsoknownas	concept_country_ivory_coast
concept_country_republic	concept:countryalsoknownas	concept_country_jordan
concept_country_republic	concept:countryalsoknownas	concept_country_kazakhstan
concept_country_republic	concept:countryalsoknownas	concept_country_lesotho
concept_country_republic	concept:countryalsoknownas	concept_country_liberia
concept_country_republic	concept:countryalsoknownas	concept_country_libya
concept_country_republic	concept:countryalsoknownas	concept_country_luxembourg
concept_country_republic	concept:countryalsoknownas	concept_country_macedonia
concept_country_republic	concept:countryalsoknownas	concept_country_madagascar
concept_country_republic	concept:countryalsoknownas	concept_country_malawi
concept_country_republic	concept:countryalsoknownas	concept_country_malaysia
concept_country_republic	concept:countryalsoknownas	concept_country_mali
concept_country_republic	concept:countryalsoknownas	concept_country_malta
concept_country_republic	concept:countryalsoknownas	concept_country_mauritania
concept_country_republic	concept:countryalsoknownas	concept_country_moldova
concept_country_republic	concept:countryalsoknownas	concept_country_mongolia
concept_country_republic	concept:countryalsoknownas	concept_country_montenegro
concept_country_republic	concept:countryalsoknownas	concept_country_morocco
concept_country_republic	concept:countryalsoknownas	concept_country_mozambique
concept_country_republic	concept:countryalsoknownas	concept_country_myanmar_burma
concept_country_republic	concept:countryalsoknownas	concept_country_nepal
concept_country_republic	concept:countryalsoknownas	concept_country_niger
concept_country_republic	concept:countryalsoknownas	concept_country_nigeria
concept_country_republic	concept:countryalsoknownas	concept_country_oman
concept_country_republic	concept:countryalsoknownas	concept_country_palestine
concept_country_republic	concept:countryalsoknownas	concept_country_panama
concept_country_republic	concept:countryalsoknownas	concept_country_papua_new_guinea
concept_country_republic	concept:countryalsoknownas	concept_country_philippines
concept_country_republic	concept:countryalsoknownas	concept_country_poland
concept_country_republic	concept:countryalsoknownas	concept_country_puerto_rico
concept_country_republic	concept:countryalsoknownas	concept_country_republic_of_angola
concept_country_republic	concept:countryalsoknownas	concept_country_republic_of_chad
concept_country_republic	concept:countryalsoknownas	concept_country_republic_of_lithuania
concept_country_republic	concept:countryalsoknownas	concept_country_republic_of_seychelles
concept_country_republic	concept:countryalsoknownas	concept_country_romania
concept_country_republic	concept:countryalsoknownas	concept_country_rwanda
concept_country_republic	concept:countryalsoknownas	concept_country_scandinavian_countries
concept_country_republic	concept:countryalsoknownas	concept_country_scotland
concept_country_republic	concept:countryalsoknownas	concept_country_sierra_leone
concept_country_republic	concept:countryalsoknownas	concept_country_slovak_republic
concept_country_republic	concept:countryalsoknownas	concept_country_slovakia
concept_country_republic	concept:countryalsoknownas	concept_country_slovenia
concept_country_republic	concept:countryalsoknownas	concept_country_somalia
concept_country_republic	concept:countryalsoknownas	concept_country_sudan
concept_country_republic	concept:countryalsoknownas	concept_country_sweden
concept_country_republic	concept:countryalsoknownas	concept_country_tanzania
concept_country_republic	concept:countryalsoknownas	concept_country_the_united_kingdom
concept_country_republic	concept:countryalsoknownas	concept_country_togo
concept_country_republic	concept:countryalsoknownas	concept_country_uk
concept_country_republic	concept:countryalsoknownas	concept_country_ukraine
concept_country_republic	concept:countryalsoknownas	concept_country_uruguay
concept_country_republic	concept:countryalsoknownas	concept_country_venezuela
concept_country_republic	concept:countryalsoknownas	concept_country_wales
concept_country_republic	concept:countryalsoknownas	concept_country_zimbabwe
concept_country_republic	concept:countrylocatedingeopoliticallocation	concept_country_countries
concept_country_republic	concept:countrylocatedingeopoliticallocation	concept_geopoliticallocation_european_nations
concept_country_saint_kitts_and_nevis	concept:agentbelongstoorganization	concept_sportsleague_mls
concept_country_scandinavia	concept:countrylocatedingeopoliticallocation	concept_geopoliticallocation_destinations
concept_country_scotland	concept:countrycurrency	concept_currency_pounds
concept_country_spain	concept:countrylocatedingeopoliticallocation	concept_geopoliticallocation_european_nations
concept_country_sweden	concept:countrycurrency	concept_currency_krona
concept_country_syria	concept:countrylocatedingeopoliticallocation	concept_country_countries
concept_country_the_philippines	concept:countryalsoknownas	concept_country_republic
concept_country_trinidad_and_tobago	concept:agentbelongstoorganization	concept_sportsleague_mls
concept_country_uk__canada	concept:countryalsoknownas	concept_country_republic
concept_country_ussr_	concept:countrylocatedingeopoliticallocation	concept_country_countries
concept_country_venezuela	concept:countrylocatedingeopoliticallocation	concept_geopoliticallocation_producers
concept_county_brooklyn	concept:mutualproxyfor	concept_company_new_york
concept_county_elkins	concept:locationlocatedwithinlocation	concept_stateorprovince_west_virginia
concept_county_paris	concept:atdate	concept_date_n1941
concept_county_radford	concept:proxyfor	concept_stateorprovince_virginia
concept_county_salem	concept:atlocation	concept_stateorprovince_ohio
concept_creditunion_michigan	concept:subpartoforganization	concept_sportsteam_ncaa_mens_midwest_regionals
concept_criminal_email	concept:agentinvolvedwithitem	concept_buildingfeature_window
concept_criminal_john	concept:persondiedatage	2
concept_criminal_thursday	concept:atdate	concept_date_community
concept_criminal_web_pages	concept:agentinvolvedwithitem	concept_buildingfeature_window
concept_date_bill	concept:subpartof	concept_university_microsoft
concept_date_dec_	concept:atdate	concept_date_community
concept_date_fall	concept:proxyfor	concept_stateorprovince_virginia
concept_date_feb_	concept:atdate	concept_date_community
concept_date_frontpage	concept:mutualproxyfor	concept_university_microsoft
concept_date_nov_	concept:atdate	concept_date_community
concept_date_sept_	concept:atdate	concept_date_community
concept_emotion_northeastern	concept:mutualproxyfor	concept_company_missouri
concept_emotion_word	concept:mutualproxyfor	concept_university_microsoft
concept_ethnicgroup_union_forces	concept:atdate	concept_year_n1865
concept_eventoutcome_battle	concept:atdate	concept_date_n1944
concept_female_daw_aung_san_suu_kyi	concept:personhasjobposition	concept_jobposition_leader
concept_female_sarah	concept:persondiedatage	2
concept_fish_anchovies	concept:agriculturalproductcutintogeometricshape	concept_geometricshape_bits
concept_fish_barracuda	concept:animalistypeofanimal	concept_fish_pelagics
concept_fish_billfish	concept:animalsuchasfish	concept_fish_blue_marlin
concept_fish_cod	concept:agriculturalproductcutintogeometricshape	concept_geometricshape_cubes
concept_fish_game_fish	concept:animalsuchasfish	concept_fish_marlin
concept_fish_gamefish	concept:animalsuchasfish	concept_fish_tuna
concept_fish_large_fish	concept:animalsuchasfish	concept_fish_marlin
concept_fish_large_fish	concept:animalsuchasfish	concept_fish_tuna
concept_fish_larger_fish	concept:animalsuchasfish	concept_fish_swordfish
concept_fish_manta_rays	concept:animalistypeofanimal	concept_fish_pelagics
concept_fish_mantas	concept:animalistypeofanimal	concept_fish_pelagics
concept_fish_oily_fish	concept:animalsuchasfish	concept_fish_tuna
concept_fish_pelagics	concept:animalsuchasfish	concept_fish_marlin
concept_fish_pelagics	concept:animalsuchasfish	concept_fish_sharks
concept_fish_pelagics	concept:animalsuchasfish	concept_fish_sunfish
concept_fish_predatory_fish	concept:animalsuchasfish	concept_fish_tuna
concept_fish_sailfish	concept:animalistypeofanimal	concept_fish_billfish
concept_fish_sharks	concept:animalistypeofanimal	concept_fish_fishes
concept_fish_sharks	concept:animalpreyson	concept_fish_sharks
concept_fish_swordfish	concept:animalistypeofanimal	concept_fish_billfish
concept_fish_swordfish	concept:animalistypeofanimal	concept_fish_tunas
concept_fish_swordfish	concept:fishservedwithfood	concept_bakedgood_butter
concept_fish_tours	concept:agentinvolvedwithitem	concept_buildingfeature_window
concept_fish_tuna	concept:agriculturalproductcutintogeometricshape	concept_geometricshape_cubes
concept_fish_tuna	concept:animaleatvegetable	concept_vegetable_lettuce
concept_fish_tuna	concept:fishservedwithfood	concept_agriculturalproduct_asparagus
concept_fish_tuna	concept:fishservedwithfood	concept_automobileengine_production
concept_fish_tuna	concept:fishservedwithfood	concept_bakedgood_appetizer
concept_fish_tuna	concept:fishservedwithfood	concept_bakedgood_pasta
concept_fish_tuna	concept:fishservedwithfood	concept_bakedgood_salad_sandwich
concept_fish_tuna	concept:fishservedwithfood	concept_bakedgood_sauce
concept_fish_tuna	concept:fishservedwithfood	concept_bakedgood_starter
concept_fish_tuna	concept:fishservedwithfood	concept_beverage__
concept_fish_tuna	concept:fishservedwithfood	concept_beverage_breakfast
concept_fish_tuna	concept:fishservedwithfood	concept_beverage_imports
concept_fish_tuna	concept:fishservedwithfood	concept_beverage_slice
concept_fish_tuna	concept:fishservedwithfood	concept_condiment_avocado
concept_fish_tuna	concept:fishservedwithfood	concept_condiment_crust
concept_fish_tuna	concept:fishservedwithfood	concept_condiment_ginger
concept_fish_tuna	concept:fishservedwithfood	concept_condiment_ginger_sauce
concept_fish_tuna	concept:fishservedwithfood	concept_condiment_mayonnaise
concept_fish_tuna	concept:fishservedwithfood	concept_condiment_ponzu
concept_fish_tuna	concept:fishservedwithfood	concept_condiment_relish
concept_fish_tuna	concept:fishservedwithfood	concept_condiment_salsa
concept_fish_tuna	concept:fishservedwithfood	concept_condiment_wasabi
concept_fish_tuna	concept:fishservedwithfood	concept_food_lunch
concept_fish_tuna	concept:fishservedwithfood	concept_food_salad_recipe
concept_fish_tuna	concept:fishservedwithfood	concept_food_serving
concept_fish_tuna	concept:fishservedwithfood	concept_food_slices
concept_fish_tuna	concept:fishservedwithfood	concept_food_sushi
concept_fish_tuna	concept:fishservedwithfood	concept_grain_management
concept_fish_tuna	concept:fishservedwithfood	concept_meat_dish
concept_fish_tuna	concept:fishservedwithfood	concept_meat_top
concept_fish_tuna	concept:fishservedwithfood	concept_nut_case
concept_fish_tuna	concept:fishservedwithfood	concept_vegetable_cut
concept_fish_tuna	concept:fishservedwithfood	concept_vegetable_dinner
concept_fish_tuna	concept:fishservedwithfood	concept_vegetable_fillet
concept_fish_tuna	concept:fishservedwithfood	concept_visualizablething_cans
concept_fish_tuna	concept:fishservedwithfood	concept_visualizablething_filet
concept_fish_tuna	concept:fishservedwithfood	concept_visualizablething_loin
concept_food_apples	concept:agriculturalproductcamefromcountry	concept_country___america
concept_food_apples	concept:agriculturalproductcutintogeometricshape	concept_geometricshape_cubes
concept_food_apples	concept:agriculturalproductcutintogeometricshape	concept_geometricshape_dice
concept_food_butternut_squash	concept:agriculturalproductcutintogeometricshape	concept_geometricshape_cubes
concept_food_egg	concept:agriculturalproductcutintogeometricshape	concept_geometricshape_cubes
concept_food_eggplant	concept:agriculturalproductcutintogeometricshape	concept_geometricshape_cubes
concept_food_papaya	concept:agriculturalproductcutintogeometricshape	concept_geometricshape_cubes
concept_food_pastures	concept:objectfoundinscene	concept_landscapefeatures_valley
concept_food_pumpkin	concept:agriculturalproductcutintogeometricshape	concept_geometricshape_cubes
concept_food_sushi	concept:foodcancausedisease	concept_disease_food_poisoning
concept_food_sweet_potatoes	concept:agriculturalproductcutintogeometricshape	concept_geometricshape_cubes
concept_food_tofu	concept:agriculturalproductcutintogeometricshape	concept_geometricshape_cubes
concept_fruit_pears	concept:agriculturalproductcutintogeometricshape	concept_geometricshape_dice
concept_furniture_bed	concept:furniturefoundinroom	concept_officebuildingroom_air_conditioned_master_bedroom
concept_furniture_bed	concept:furniturefoundinroom	concept_officebuildingroom_garden_view_room
concept_furniture_bed	concept:furniturefoundinroom	concept_officebuildingroom_lounge_dining_room
concept_furniture_bed	concept:furniturefoundinroom	concept_officebuildingroom_luxury_suites
concept_furniture_bed	concept:furniturefoundinroom	concept_officebuildingroom_master_bedroom_suites
concept_furniture_bed	concept:furniturefoundinroom	concept_officebuildingroom_penthouse_suites
concept_furniture_bed	concept:furniturefoundinroom	concept_officebuildingroom_room_suites
concept_furniture_bed	concept:furniturefoundinroom	concept_officebuildingroom_spacious_main_bedroom
concept_furniture_bed	concept:furniturefoundinroom	concept_officebuildingroom_superior_room
concept_furniture_bed	concept:furniturefoundinroom	concept_officebuildingroom_superior_rooms
concept_furniture_bed	concept:furniturefoundinroom	concept_officebuildingroom_two_bedroom_cottages
concept_furniture_bed	concept:furniturefoundinroom	concept_officebuildingroom_two_guest_bedrooms
concept_furniture_bed	concept:furniturefoundinroom	concept_room_balcony_room
concept_furniture_bed	concept:furniturefoundinroom	concept_room_beautiful_master_bedroom
concept_furniture_bed	concept:furniturefoundinroom	concept_room_beautiful_master_suite
concept_furniture_bed	concept:furniturefoundinroom	concept_room_bed_sitting_room
concept_furniture_bed	concept:furniturefoundinroom	concept_room_connecting_room
concept_furniture_bed	concept:furniturefoundinroom	concept_room_delightful_room
concept_furniture_bed	concept:furniturefoundinroom	concept_room_downstairs_master
concept_furniture_bed	concept:furniturefoundinroom	concept_room_floor_loft
concept_furniture_bed	concept:furniturefoundinroom	concept_room_gardens
concept_furniture_bed	concept:furniturefoundinroom	concept_room_ground_floor_master
concept_furniture_bed	concept:furniturefoundinroom	concept_room_hallway
concept_furniture_bed	concept:furniturefoundinroom	concept_room_large_kitchen
concept_furniture_bed	concept:furniturefoundinroom	concept_room_large_living_dining_room
concept_furniture_bed	concept:furniturefoundinroom	concept_room_large_lounge
concept_furniture_bed	concept:furniturefoundinroom	concept_room_main_suite
concept_furniture_bed	concept:furniturefoundinroom	concept_room_master_bedroom_upstairs
concept_furniture_bed	concept:furniturefoundinroom	concept_room_master_suite_upstairs
concept_furniture_bed	concept:furniturefoundinroom	concept_room_mezzanine_area
concept_furniture_bed	concept:furniturefoundinroom	concept_room_ocean_views
concept_furniture_bed	concept:furniturefoundinroom	concept_room_oversized_master_suite
concept_furniture_bed	concept:furniturefoundinroom	concept_room_presidential_suite
concept_furniture_bed	concept:furniturefoundinroom	concept_room_private_master_bedroom
concept_furniture_bed	concept:furniturefoundinroom	concept_room_regular_room
concept_furniture_bed	concept:furniturefoundinroom	concept_room_roof
concept_furniture_bed	concept:furniturefoundinroom	concept_room_second_guest_room
concept_furniture_bed	concept:furniturefoundinroom	concept_room_separate_lounge
concept_furniture_bed	concept:furniturefoundinroom	concept_room_separate_seating_area
concept_furniture_bed	concept:furniturefoundinroom	concept_room_small_living_room
concept_furniture_bed	concept:furniturefoundinroom	concept_room_small_lounge
concept_furniture_bed	concept:furniturefoundinroom	concept_room_spacious_lounge
concept_furniture_bed	concept:furniturefoundinroom	concept_room_staircase
concept_furniture_bed	concept:furniturefoundinroom	concept_room_studio_bedroom
concept_furniture_bed	concept:furniturefoundinroom	concept_room_third_level
concept_furniture_bed	concept:furniturefoundinroom	concept_visualizablescene_structure
concept_furniture_bed	concept:furniturefoundinroom	concept_visualizablething_green_bedroom
concept_furniture_bed	concept:furniturefoundinroom	concept_visualizablething_guest_bedroom
concept_furniture_bed	concept:furniturefoundinroom	concept_visualizablething_loft_bedroom
concept_furniture_bed	concept:furniturefoundinroom	concept_visualizablething_lower_floor
concept_furniture_bed	concept:furniturefoundinroom	concept_visualizablething_one_suite
concept_furniture_bed	concept:furniturefoundinroom	concept_visualizablething_parlor
concept_furniture_bed	concept:furniturefoundinroom	concept_visualizablething_sixth_bedroom
concept_furniture_bed	concept:furniturefoundinroom	concept_visualizablething_smaller_bedroom
concept_furniture_bed	concept:furniturefoundinroom	concept_visualizablething_third_master_bedroom
concept_furniture_bed	concept:furniturefoundinroom	concept_visualizablething_views
concept_furniture_bunk_beds	concept:furniturefoundinroom	concept_visualizablething_bedrooms
concept_furniture_bunk_beds	concept:furniturefoundinroom	concept_visualizablething_bunk_room
concept_furniture_canopy_beds	concept:furniturefoundinroom	concept_visualizablething_bedrooms
concept_furniture_divan_beds	concept:furniturefoundinroom	concept_visualizablething_bedrooms
concept_furniture_double_wardrobes	concept:furniturefoundinroom	concept_visualizablething_bedrooms
concept_furniture_king_beds	concept:furniturefoundinroom	concept_visualizablething_bedrooms
concept_furniture_log_beds	concept:itemfoundinroom	concept_visualizablething_bedrooms
concept_furniture_queen_beds	concept:furniturefoundinroom	concept_visualizablething_bedrooms
concept_furniture_sleeper_sofa	concept:furniturefoundinroom	concept_visualizablething_bedrooms
concept_furniture_sleeper_sofa	concept:itemfoundinroom	concept_officebuildingroom_great_room
concept_furniture_sofa_bed	concept:itemfoundinroom	concept_visualizableobject_apartment
concept_geometricshape_euclid	concept:atlocation	concept_stateorprovince_ohio
concept_geopoliticallocation_bowling_green	concept:atlocation	concept_stateorprovince_ohio
concept_geopoliticallocation_burma	concept:atdate	concept_date_n1944
concept_geopoliticallocation_kerry	concept:agentcollaborateswithagent	concept_personus_john_edwards
concept_geopoliticallocation_st__charles	concept:proxyfor	concept_company_missouri
concept_geopoliticalorganization_venue	concept:subpartoforganization	concept_terroristorganization_state
concept_governmentorganization_courts	concept:subpartoforganization	concept_terroristorganization_state
concept_governmentorganization_departments	concept:subpartoforganization	concept_terroristorganization_state
concept_governmentorganization_executive_orders	concept:subpartoforganization	concept_terroristorganization_state
concept_governmentorganization_owner	concept:atdate	concept_year_n1919
concept_governmentorganization_program	concept:agentinvolvedwithitem	concept_buildingfeature_window
concept_governmentorganization_rule	concept:subpartoforganization	concept_terroristorganization_state
concept_governmentorganization_standards	concept:subpartoforganization	concept_terroristorganization_state
concept_governmentorganization_techniques	concept:subpartof	concept_weatherphenomenon_air
concept_grain_experience	concept:objectfoundinscene	concept_landscapefeatures_valley
concept_hallwayitem_access	concept:subpartof	concept_hallwayitem_air
concept_hallwayitem_areas	concept:subpartof	concept_hallwayitem_air
concept_hallwayitem_auto	concept:subpartof	concept_hallwayitem_air
concept_hallwayitem_basement	concept:subpartof	concept_hallwayitem_air
concept_hallwayitem_boat	concept:subpartof	concept_hallwayitem_air
concept_hallwayitem_check	concept:subpartof	concept_hallwayitem_air
concept_hallwayitem_console	concept:subpartof	concept_hallwayitem_air
concept_hallwayitem_contact	concept:subpartof	concept_hallwayitem_air
concept_hallwayitem_controls	concept:subpartof	concept_hallwayitem_air
concept_hallwayitem_display	concept:subpartof	concept_hallwayitem_air
concept_hallwayitem_enclosure	concept:subpartof	concept_hallwayitem_air
concept_hallwayitem_interior	concept:subpartof	concept_hallwayitem_air
concept_hallwayitem_market	concept:subpartof	concept_hallwayitem_air
concept_hallwayitem_point	concept:subpartof	concept_hallwayitem_air
concept_hallwayitem_problem	concept:subpartof	concept_hallwayitem_air
concept_hallwayitem_process	concept:subpartof	concept_hallwayitem_air
concept_hallwayitem_refrigerator	concept:subpartof	concept_hallwayitem_air
concept_hallwayitem_solution	concept:subpartof	concept_hallwayitem_air
concept_hallwayitem_tower	concept:subpartof	concept_hallwayitem_air
concept_hallwayitem_van	concept:subpartof	concept_hallwayitem_air
concept_highway_chesterfield	concept:proxyfor	concept_company_missouri
concept_hobby_activities	concept:hobbiessuchashobbies	concept_sport_rafting
concept_hobby_activities	concept:hobbiessuchashobbies	concept_sport_watersports
concept_hobby_fishing	concept:sportfansincountry	concept_country___america
concept_hobby_hiking	concept:sportfansincountry	concept_country___america
concept_hobby_hobbies	concept:hobbiessuchashobbies	concept_sport_soccer
concept_hobby_weight_lifting	concept:sportusesequipment	concept_sportsequipment_equipment
concept_hotel_beau_rivage	concept:hotelincity	concept_city_geneva
concept_hotel_fairmont	concept:atlocation	concept_stateorprovince_west_virginia
concept_hotel_warwick	concept:hotelincity	concept_city_geneva
concept_householditem_bedroom	concept:itemfoundinroom	concept_visualizableobject_apartment
concept_householditem_bedroom	concept:itemfoundinroom	concept_visualizablething_downstairs
concept_householditem_bedroom	concept:itemfoundinroom	concept_visualizablething_lower_floor
concept_householditem_bedroom	concept:subpartof	concept_weatherphenomenon_air
concept_island_british_virgin_islands	concept:countrylocatedingeopoliticallocation	concept_country_countries
concept_island_marshall_islands	concept:atdate	concept_date_n1944
concept_island_marshall_islands	concept:countrylocatedingeopoliticallocation	concept_country_countries
concept_island_mother	concept:atdate	concept_year_n1865
concept_island_truk	concept:atdate	concept_date_n1944
concept_journalist_adam_liptak	concept:worksfor	concept_musicartist_times
concept_journalist_adam_nagourney	concept:personbelongstoorganization	concept_musicartist_times
concept_journalist_alissa_j__rubin	concept:worksfor	concept_musicartist_times
concept_journalist_david_shaw	concept:worksfor	concept_televisionstation_los_angeles_times
concept_journalist_eric_dash	concept:worksfor	concept_musicartist_times
concept_journalist_gina_kolata	concept:personbelongstoorganization	concept_musicartist_times
concept_journalist_howard_rosenberg	concept:worksfor	concept_televisionstation_los_angeles_times
concept_journalist_james_dao	concept:worksfor	concept_musicartist_times
concept_journalist_james_ridgeway	concept:journalistwritesforpublication	concept_politicsblog_village_voice
concept_journalist_jane_brody	concept:worksfor	concept_musicartist_times
concept_journalist_jim_murray	concept:worksfor	concept_televisionstation_los_angeles_times
concept_journalist_john	concept:persondiedatage	2
concept_journalist_kevin_sack	concept:worksfor	concept_musicartist_times
concept_journalist_kurt_eichenwald	concept:worksfor	concept_musicartist_times
concept_journalist_maria	concept:persondiedatage	2
concept_journalist_mike_anderson	concept:worksfor	concept_company_missouri
concept_journalist_nat_hentoff	concept:journalistwritesforpublication	concept_politicsblog_village_voice
concept_journalist_ronald_brownstein	concept:worksfor	concept_televisionstation_los_angeles_times
concept_journalist_sam_dillon	concept:worksfor	concept_musicartist_times
concept_journalist_steven_lee_myers	concept:worksfor	concept_musicartist_times
concept_journalist_tara_parker_pope	concept:worksfor	concept_musicartist_times
concept_journalist_tim_rutten	concept:worksfor	concept_televisionstation_los_angeles_times
concept_judge_personnel	concept:agentbelongstoorganization	concept_terroristorganization_state
concept_lake_atlantic	concept:lakeinstate	concept_stateorprovince_ontario
concept_lake_bay_of_quinte	concept:lakeinstate	concept_stateorprovince_ontario
concept_lake_cayuga_lake	concept:lakeinstate	concept_stateorprovince_ontario
concept_lake_hamilton_harbour	concept:lakeinstate	concept_stateorprovince_ontario
concept_lake_irondequoit_bay	concept:lakeinstate	concept_stateorprovince_ontario
concept_lake_lake_erie	concept:lakeinstate	concept_stateorprovince_ontario
concept_lake_lake_ontario	concept:lakeinstate	concept_stateorprovince_ontario
concept_lake_lower_niagara_river	concept:lakeinstate	concept_stateorprovince_ontario
concept_lake_niagara_river	concept:lakeinstate	concept_stateorprovince_ontario
concept_lake_saint_lawrence	concept:lakeinstate	concept_stateorprovince_ontario
concept_lake_saint_lawrence_river	concept:lakeinstate	concept_stateorprovince_ontario
concept_lake_salmon_river	concept:lakeinstate	concept_stateorprovince_ontario
concept_lake_scarborough_bluffs	concept:lakeinstate	concept_stateorprovince_ontario
concept_lake_sodus_bay	concept:lakeinstate	concept_stateorprovince_ontario
concept_lake_st___lawrence	concept:lakeinstate	concept_stateorprovince_ontario
concept_lake_st___lawrence_river	concept:lakeinstate	concept_stateorprovince_ontario
concept_lake_st___lawrence_seaway	concept:lakeinstate	concept_stateorprovince_ontario
concept_lake_st_lawrence	concept:lakeinstate	concept_stateorprovince_ontario
concept_lake_st_lawrence_river	concept:lakeinstate	concept_stateorprovince_ontario
concept_lake_upper_great_lakes	concept:lakeinstate	concept_stateorprovince_ontario
concept_landscapefeatures_camp	concept:atdate	concept_date_n1944
concept_language_arabic	concept:languageofcountry	concept_country_djibouti
concept_language_arabic	concept:languageofuniversity	concept_university_hebrew_university
concept_language_dutch	concept:languageofcountry	concept_country___america
concept_language_first_english	concept:languageofcountry	concept_country___america
concept_language_french	concept:languageofcountry	concept_country_new_caledonia
concept_language_french	concept:languageofcountry	concept_country_republic
concept_language_french	concept:languageofcountry	concept_country_republic_of_vanuatu
concept_language_french	concept:languageofcountry	concept_country_western_africa
concept_language_french	concept:languageofuniversity	concept_school_columbia
concept_language_french	concept:languageofuniversity	concept_school_oxford
concept_language_french	concept:languageofuniversity	concept_university_catholic_university
concept_language_french	concept:languageofuniversity	concept_university_edinburgh_university
concept_language_french	concept:languageofuniversity	concept_university_oberlin_college
concept_language_french	concept:languageofuniversity	concept_university_stanford_university
concept_language_german	concept:languageofcountry	concept_country_hungary
concept_language_hausa	concept:languageofcountry	concept_country_nigeria
concept_language_hebrew	concept:languageofcountry	concept_country_israel
concept_language_hebrew	concept:languageofuniversity	concept_university_ben_gurion_university
concept_language_hebrew	concept:languageofuniversity	concept_university_haifa_university
concept_language_hebrew	concept:languageofuniversity	concept_university_london_university
concept_language_hebrew	concept:languageofuniversity	concept_university_technion
concept_language_hebrew	concept:languageofuniversity	concept_university_weizmann_institute
concept_language_hebrew	concept:languageofuniversity	concept_university_yeshiva_university
concept_language_latin	concept:languageofuniversity	concept_university_duke_university
concept_language_latin	concept:languageofuniversity	concept_university_stanford_university
concept_language_latin	concept:languageofuniversity	concept_university_uc_berkeley
concept_language_macedonian	concept:languageofcountry	concept_country_republic
concept_language_slavic	concept:languageofcountry	concept_country_macedonia
concept_magazine_bungie	concept:subpartoforganization	concept_university_microsoft
concept_magazine_plans	concept:agentinvolvedwithitem	concept_buildingfeature_window
concept_magazine_story	concept:agentcompeteswithagent	concept_university_search
concept_male_colombia	concept:agentbelongstoorganization	concept_sportsleague_mls
concept_male_isaac	concept:athleteinjuredhisbodypart	concept_braintissue_eyes
concept_male_oct	concept:atdate	concept_date_meeting
concept_meat_bacon	concept:agriculturalproductcutintogeometricshape	concept_geometricshape_bits
concept_meat_beef	concept:agriculturalproductcutintogeometricshape	concept_geometricshape_cubes
concept_meat_chicken	concept:agriculturalproductcutintogeometricshape	concept_geometricshape_cubes
concept_meat_chicken_breast	concept:agriculturalproductcutintogeometricshape	concept_geometricshape_cubes
concept_meat_chicken_breasts	concept:agriculturalproductcutintogeometricshape	concept_geometricshape_cubes
concept_meat_culture	concept:objectfoundinscene	concept_landscapefeatures_valley
concept_meat_ham	concept:agriculturalproductcutintogeometricshape	concept_geometricshape_cubes
concept_meat_pork	concept:agriculturalproductcutintogeometricshape	concept_geometricshape_cubes
concept_meat_salmon	concept:agriculturalproductcutintogeometricshape	concept_geometricshape_dice
concept_meat_steak	concept:agriculturalproductcutintogeometricshape	concept_geometricshape_cubes
concept_medicalprocedure_oct_	concept:atdate	concept_date_community
concept_militaryconflict_paris_peace_conference	concept:atdate	concept_year_n1919
concept_militaryconflict_tobruk	concept:atdate	concept_date_n1941
concept_mlalgorithm_excel	concept:mutualproxyfor	concept_university_microsoft
concept_mlalgorithm_solutions	concept:subpartof	concept_weatherphenomenon_air
concept_mlauthor_papers	concept:agentinvolvedwithitem	concept_buildingfeature_window
concept_mldataset_groups	concept:subpartof	concept_hallwayitem_air
concept_mldataset_jan	concept:atdate	concept_date_community
concept_mldataset_quincy	concept:mutualproxyfor	concept_company_missouri
concept_mldataset_site	concept:subpartof	concept_hallwayitem_air
concept_mldataset_trailer	concept:subpartof	concept_hallwayitem_air
concept_model_magnus	concept:personhascitizenship	concept_country_sweden
concept_mollusk_image_file	concept:agentinvolvedwithitem	concept_buildingfeature_window
concept_monarch_cold_winter	concept:atdate	concept_date_community
concept_month_april	concept:atdate	concept_date_community
concept_month_february	concept:atdate	concept_date_community
concept_month_january	concept:atdate	concept_date_community
concept_month_march	concept:atdate	concept_date_community
concept_month_september	concept:atdate	concept_date_community
concept_month_september	concept:atdate	concept_date_meeting
concept_mountain_allegheny_mountains	concept:mountaininstate	concept_stateorprovince_virginia
concept_mountain_beautiful_appalachian_mountains	concept:mountaininstate	concept_stateorprovince_virginia
concept_mountain_campbell_hill	concept:mountaininstate	concept_stateorprovince_ohio
concept_mountain_mount_miserable	concept:mountaininstate	concept_stateorprovince_ohio
concept_mountain_mount_rogers	concept:mountaininstate	concept_stateorprovince_virginia
concept_mountain_spruce_knob	concept:mountaininstate	concept_stateorprovince_west_virginia
concept_museum_steve	concept:proxyfor	concept_university_microsoft
concept_musicalbum_events	concept:atdate	concept_date_n1944
concept_musicalbum_hermann	concept:proxyfor	concept_company_missouri
concept_musicalbum_invasion	concept:atdate	concept_date_n1941
concept_musicalbum_liberation	concept:atdate	concept_date_n1944
concept_musicalbum_today	concept:atdate	concept_date_community
concept_musicalbum_tomorrow	concept:atdate	concept_date_community
concept_musicalbum_winter	concept:atdate	concept_date_meeting
concept_musicartist_bottom	concept:agentinvolvedwithitem	concept_buildingfeature_window
concept_musicartist_load	concept:agentinvolvedwithitem	concept_buildingfeature_window
concept_musicartist_offensive	concept:atdate	concept_date_n1944
concept_musicartist_session	concept:atdate	concept_year_n1946
concept_musicartist_takeo_fukui	concept:agentcontrols	concept_automobilemaker_honda
concept_musicartist_times	concept:agentactsinlocation	concept_city_baghdad
concept_musicartist_times	concept:agentactsinlocation	concept_city_l_a_
concept_musicartist_times	concept:agentactsinlocation	concept_country_scandinavia
concept_musicartist_times	concept:agentcollaborateswithagent	concept_blog_paul_krugman
concept_musicartist_times	concept:agentcollaborateswithagent	concept_journalist_john_markoff
concept_musicartist_times	concept:agentcollaborateswithagent	concept_journalist_maureen_dowd
concept_musicartist_times	concept:agentcollaborateswithagent	concept_journalist_nicholas_kristof
concept_musicartist_times	concept:agentinvolvedwithitem	concept_buildingfeature_window
concept_musicartist_times	concept:agentinvolvedwithitem	concept_buildingfeature_windows
concept_musicartist_times	concept:organizationdissolvedatdate	concept_month_june
concept_musicartist_times	concept:organizationdissolvedatdate	concept_month_october
concept_musicartist_type	concept:agentinvolvedwithitem	concept_buildingfeature_window
concept_musician_john	concept:persondiedatage	2
concept_musician_justin	concept:persondiedatage	20
concept_musician_studio	concept:agentbelongstoorganization	concept_terroristorganization_state
concept_musicinstrument_base	concept:objectfoundinscene	concept_landscapefeatures_valley
concept_musicinstrument_photo	concept:objectfoundinscene	concept_landscapefeatures_valley
concept_musicsong_mediterranean	concept:atdate	concept_date_n1941
concept_musicsong_summer	concept:atdate	concept_date_meeting
concept_newspaper_kgw_tv	concept:subpartof	concept_retailstore_nbc
concept_newspaper_krnv_tv	concept:subpartof	concept_retailstore_nbc
concept_newspaper_wowt	concept:subpartof	concept_retailstore_nbc
concept_nondiseasecondition_condo	concept:subpartof	concept_hallwayitem_air
concept_nondiseasecondition_discharge	concept:atdate	concept_year_n1946
concept_nongovorganization_information	concept:agentbelongstoorganization	concept_governmentorganization_governments
concept_nongovorganization_information	concept:agentcollaborateswithagent	concept_person_government
concept_nongovorganization_information	concept:agentcollaborateswithagent	concept_terroristorganization_state
concept_nongovorganization_information	concept:agentcreated	concept_academicfield_history_contact
concept_nongovorganization_information	concept:agentcreated	concept_aquarium_u_s__contact
concept_nongovorganization_information	concept:agentcreated	concept_ceo_business_contact
concept_nongovorganization_information	concept:agentcreated	concept_ceo_sale_contact
concept_nongovorganization_information	concept:agentcreated	concept_criminal_links_contact
concept_nongovorganization_information	concept:agentcreated	concept_eventoutcome_more_contact
concept_nongovorganization_information	concept:agentcreated	concept_mlarea_call
concept_nongovorganization_information	concept:agentcreated	concept_musicsong_questions_contact
concept_nongovorganization_information	concept:agentcreated	concept_personasia_share_email
concept_nongovorganization_information	concept:agentcreated	concept_scientificterm_info_contact
concept_nongovorganization_information	concept:agentcreated	concept_scientificterm_information_click
concept_nongovorganization_information	concept:agentcreated	concept_stateorprovince_mailing
concept_nongovorganization_information	concept:agentcreated	concept_weapon_course
concept_nongovorganization_representatives	concept:agentbelongstoorganization	concept_terroristorganization_state
concept_nongovorganization_u_s__navy	concept:atdate	concept_date_n1941
concept_nonneginteger_one	concept:atdate	concept_date_community
concept_nut_wall	concept:objectfoundinscene	concept_landscapefeatures_valley
concept_organization_colombia	concept:hasofficeincountry	concept_country___america
concept_organization_league_of_nations	concept:organizationheadquarteredincity	concept_city_geneva
concept_organization_lehman_brothers_holdings_inc__	concept:subpartoforganization	concept_bank_barclays
concept_organization_mtctechnologies	concept:organizationheadquarteredinstateorprovince	concept_stateorprovince_ohio
concept_park_first_friday	concept:atdate	concept_date_meeting
concept_park_n1	concept:atdate	concept_date_community
concept_person_abbas	concept:agentcontrols	concept_agent_security_forces
concept_person_abbas	concept:personleadsorganization	concept_bank_administration
concept_person_abbas	concept:personleadsorganization	concept_biotechcompany_pa
concept_person_abbas	concept:personleadsorganization	concept_company_credibility
concept_person_abbas	concept:personleadsorganization	concept_country_party
concept_person_abbas	concept:personleadsorganization	concept_governmentorganization_rule
concept_person_abbas	concept:personleadsorganization	concept_musicartist_faction
concept_person_abbas	concept:personleadsorganization	concept_nongovorganization_fatah_leadership
concept_person_abbas	concept:personleadsorganization	concept_nongovorganization_rival_fatah
concept_person_abbas	concept:personleadsorganization	concept_politicalparty_moderates
concept_person_abbas	concept:personleadsorganization	concept_politicalparty_movement
concept_person_abbas	concept:personleadsorganization	concept_politicalparty_palestine_authority
concept_person_abbas	concept:personleadsorganization	concept_politicalparty_palestinian_national_authority
concept_person_abbas	concept:personleadsorganization	concept_terroristorganization_fatah_faction
concept_person_abbas	concept:personleadsorganization	concept_terroristorganization_fatah_forces
concept_person_abbas	concept:personleadsorganization	concept_terroristorganization_fatah_movement
concept_person_abbas	concept:personleadsorganization	concept_terroristorganization_fatah_party
concept_person_abbas	concept:personleadsorganization	concept_terroristorganization_fatah_security_forces
concept_person_abbas	concept:personleadsorganization	concept_terroristorganization_fateh
concept_person_abbas	concept:personleadsorganization	concept_terroristorganization_moderate_fatah_party
concept_person_abbas	concept:personleadsorganization	concept_terroristorganization_palestinian_authority
concept_person_abbas	concept:personleadsorganization	concept_terroristorganization_palestinian_government
concept_person_abbas	concept:personleadsorganization	concept_terroristorganization_palestinian_leadership
concept_person_abbas	concept:personleadsorganization	concept_terroristorganization_plo
concept_person_abbas	concept:personleadsorganization	concept_terroristorganization_rival_fatah_faction
concept_person_abbas	concept:personleadsorganization	concept_terroristorganization_rival_fatah_movement
concept_person_abbas	concept:personleadsorganization	concept_terroristorganization_rival_fatah_party
concept_person_abbas	concept:personleadsorganization	concept_terroristorganization_secular_fatah_faction
concept_person_abbas	concept:personleadsorganization	concept_terroristorganization_west_bank
concept_person_abbas	concept:personleadsorganization	concept_terroristorganization_wing
concept_person_abbas	concept:personleadsorganization	concept_tradeunion_security
concept_person_abdullah_ocalan	concept:personhasjobposition	concept_jobposition_leader
concept_person_al001	concept:personborninlocation	concept_county_york_city
concept_person_alan	concept:personborninlocation	concept_county_york_city
concept_person_alex001	concept:persondiedatage	2
concept_person_andrea	concept:personborninlocation	concept_county_york_city
concept_person_annie	concept:personborninlocation	concept_county_york_city
concept_person_arnaldo_otegi	concept:personhasjobposition	concept_jobposition_leader
concept_person_arthur	concept:personborninlocation	concept_county_york_city
concept_person_ben_silverman	concept:agentcontrols	concept_retailstore_nbc
concept_person_benjamin	concept:persondiedatage	2
concept_person_bob_wright	concept:agentcontrols	concept_retailstore_nbc
concept_person_bob_wright001	concept:subpartof	concept_retailstore_nbc
concept_person_brooke	concept:personborninlocation	concept_county_york_city
concept_person_c	concept:persondiedatage	2
concept_person_carl	concept:personhascitizenship	concept_country_sweden
concept_person_charles001	concept:personhascitizenship	concept_country_hungary
concept_person_claire	concept:personborninlocation	concept_county_york_city
concept_person_d	concept:persondiedatage	2
concept_person_danielle	concept:personborninlocation	concept_county_york_city
concept_person_data	concept:agentinvolvedwithitem	concept_buildingfeature_window
concept_person_david	concept:personhascitizenship	concept_country_scotland
concept_person_diane001	concept:personborninlocation	concept_county_york_city
concept_person_doug	concept:personborninlocation	concept_county_york_city
concept_person_edward001	concept:personborninlocation	concept_county_york_city
concept_person_edward001	concept:personhascitizenship	concept_country_scotland
concept_person_elizabeth001	concept:hasspouse	concept_politicianus_henry
concept_person_elizabeth001	concept:personborninlocation	concept_county_york_city
concept_person_eric	concept:persondiedatage	2
concept_person_eric	concept:personhascitizenship	concept_country_sweden
concept_person_gardner	concept:persondiedatage	2
concept_person_gene	concept:personborninlocation	concept_county_york_city
concept_person_george001	concept:persondiedatage	2
concept_person_george002	concept:persondiedatage	2
concept_person_goodman	concept:personborninlocation	concept_county_york_city
concept_person_grant	concept:persondiedatage	2
concept_person_grant001	concept:personborninlocation	concept_county_york_city
concept_person_grant002	concept:persondiedatage	2
concept_person_gustaf	concept:personhascitizenship	concept_country_sweden
concept_person_hi	concept:persondiedatage	2
concept_person_hitler	concept:atdate	concept_date_n1941
concept_person_home001	concept:agentcollaborateswithagent	concept_musicartist_times
concept_person_hurston	concept:personborninlocation	concept_county_york_city
concept_person_jack001	concept:persondiedatage	2
concept_person_jack002	concept:persondiedatage	2
concept_person_jennifer001	concept:personborninlocation	concept_county_york_city
concept_person_joey	concept:persondiedatage	2
concept_person_joey001	concept:persondiedatage	2
concept_person_john002	concept:persondiedatage	2
concept_person_justin	concept:personborninlocation	concept_county_york_city
concept_person_justin	concept:persondiedatage	20
concept_person_karl	concept:personhascitizenship	concept_country_sweden
concept_person_ken	concept:persondiedatage	2
concept_person_kevin001	concept:persondiedatage	2
concept_person_king	concept:personhascitizenship	concept_country_sweden
concept_person_larry	concept:personborninlocation	concept_county_york_city
concept_person_lauren	concept:personborninlocation	concept_county_york_city
concept_person_lee	concept:persondiedatage	2
concept_person_lehman	concept:agentcontrols	concept_person_philippe_burke
concept_person_lehman	concept:subpartof	concept_bank_barclays
concept_person_lewis001	concept:personborninlocation	concept_county_york_city
concept_person_lisa001	concept:personmovedtostateorprovince	concept_stateorprovince_virginia
concept_person_lori	concept:personborninlocation	concept_county_york_city
concept_person_maria	concept:persondiedatage	2
concept_person_martin002	concept:personborninlocation	concept_county_york_city
concept_person_mason	concept:personborninlocation	concept_county_york_city
concept_person_matt001	concept:persondiedatage	2
concept_person_matt002	concept:personborninlocation	concept_county_york_city
concept_person_matthew	concept:personborninlocation	concept_county_york_city
concept_person_max	concept:persondiedatage	2
concept_person_max002	concept:persondiedatage	2
concept_person_michael002	concept:parentofperson	concept_person_jesus
concept_person_michael002	concept:persongraduatedfromuniversity	concept_university_stanford_university
concept_person_mitchell	concept:personborninlocation	concept_county_york_city
concept_person_monroe	concept:personborninlocation	concept_county_york_city
concept_person_morgan	concept:personborninlocation	concept_county_york_city
concept_person_mukwege	concept:personhasresidenceingeopoliticallocation	concept_country_democratic_republic_of_congo
concept_person_nikki	concept:persondiedatage	2
concept_person_oh002	concept:persondiedatage	2
concept_person_otis	concept:personborninlocation	concept_county_york_city
concept_person_patricia	concept:personborninlocation	concept_county_york_city
concept_person_patrick	concept:personborninlocation	concept_county_york_city
concept_person_prince	concept:personhascitizenship	concept_country_wales
concept_person_princess	concept:personhascitizenship	concept_country_wales
concept_person_queen	concept:personhascitizenship	concept_country_hungary
concept_person_reynolds	concept:personborninlocation	concept_county_york_city
concept_person_richard001	concept:persondiedatage	2
concept_person_richard002	concept:persondiedatage	2
concept_person_richard004	concept:persondiedatage	2
concept_person_robbie_bach	concept:personleadsorganization	concept_university_microsoft
concept_person_robert001	concept:persondiedatage	2
concept_person_ross	concept:personborninlocation	concept_county_york_city
concept_person_sarah	concept:persondiedatage	2
concept_person_sean002	concept:personborninlocation	concept_county_york_city
concept_person_sherman	concept:personborninlocation	concept_county_york_city
concept_person_susan	concept:personborninlocation	concept_county_york_city
concept_person_tara	concept:personborninlocation	concept_county_york_city
concept_person_tebow	concept:athleteplayssportsteamposition	concept_sportsteamposition_player
concept_person_tebow	concept:personalsoknownas	concept_athlete_tim_tebow
concept_person_technology	concept:agentbelongstoorganization	concept_terroristorganization_state
concept_person_thich_nhat_hanh	concept:personhasjobposition	concept_jobposition_leader
concept_person_tony	concept:persondiedatage	2
concept_person_torres	concept:personborninlocation	concept_county_york_city
concept_person_tyler001	concept:personborninlocation	concept_county_york_city
concept_person_vincent	concept:personborninlocation	concept_county_york_city
concept_person_wales	concept:agentbelongstoorganization	concept_sportsleague_mls
concept_person_wayne	concept:persondiedatage	20
concept_person_wayne001	concept:persondiedatage	20
concept_person_zachary	concept:personborninlocation	concept_county_york_city
concept_person_zaddick_elimelech_weissblum	concept:personhasjobposition	concept_jobposition_leader
concept_personafrica_tom_brokaw	concept:subpartof	concept_retailstore_nbc
concept_personalcareitem_children	concept:objectfoundinscene	concept_landscapefeatures_valley
concept_personalcareitem_development	concept:objectfoundinscene	concept_landscapefeatures_valley
concept_personalcareitem_maps	concept:objectfoundinscene	concept_landscapefeatures_valley
concept_personalcareitem_nature	concept:objectfoundinscene	concept_landscapefeatures_valley
concept_personasia_koti	concept:subpartof	concept_retailstore_nbc
concept_personasia_songs	concept:agentinvolvedwithitem	concept_buildingfeature_window
concept_personaustralia_david_nagel	concept:personleadsorganization	concept_company_palmsource
concept_personaustralia_edmund_l__andrews	concept:worksfor	concept_musicartist_times
concept_personaustralia_kris_boyd	concept:athletehomestadium	concept_stadiumoreventvenue_giants_stadium
concept_personaustralia_michael	concept:athleteplayssportsteamposition	concept_sportsteamposition_player
concept_personaustralia_more_information	concept:agentinvolvedwithitem	concept_buildingfeature_window
concept_personaustralia_paul_allen	concept:worksfor	concept_university_microsoft
concept_personcanada_roberta_smith	concept:worksfor	concept_musicartist_times
concept_personcanada_search_form	concept:agentinvolvedwithitem	concept_buildingfeature_window
concept_personcanada_slideshow	concept:agentinvolvedwithitem	concept_buildingfeature_window
concept_personeurope_david_beckham	concept:athleteplayssport	concept_sport_soccer
concept_personeurope_federer	concept:athletewinsawardtrophytournament	concept_awardtrophytournament_australian_open
concept_personeurope_fulton	concept:proxyfor	concept_company_missouri
concept_personeurope_isabella	concept:personhascitizenship	concept_country_spain
concept_personeurope_order	concept:agentinvolvedwithitem	concept_buildingfeature_window
concept_personeurope_richard_branson	concept:persondiedatage	2
concept_personeurope_robert	concept:persondiedatage	2
concept_personeurope_steven_greenhouse	concept:worksfor	concept_musicartist_times
concept_personeurope_whitney	concept:subpartof	concept_county_york_city
concept_personmexico_brian_leetch	concept:athletehomestadium	concept_stadiumoreventvenue_giants_stadium
concept_personmexico_chris_perez	concept:athletehomestadium	concept_stadiumoreventvenue_giants_stadium
concept_personmexico_david_tyree	concept:athletehomestadium	concept_stadiumoreventvenue_giants_stadium
concept_personmexico_eli_marrero	concept:athletehomestadium	concept_stadiumoreventvenue_giants_stadium
concept_personmexico_frank_francisco	concept:athletehomestadium	concept_stadiumoreventvenue_giants_stadium
concept_personmexico_herschel_walker	concept:athleteplayssportsteamposition	concept_sportsteamposition_running_back
concept_personmexico_jason_taylor	concept:athletehomestadium	concept_stadiumoreventvenue_giants_stadium
concept_personmexico_joe_montana	concept:athleteplayssportsteamposition	concept_sportsteamposition_player
concept_personmexico_john_riggins	concept:athleteplayssportsteamposition	concept_sportsteamposition_running_back
concept_personmexico_jose_castillo	concept:athletehomestadium	concept_stadiumoreventvenue_giants_stadium
concept_personnorthamerica_puerto_rico	concept:agentbelongstoorganization	concept_sportsleague_mls
concept_personnorthamerica_reed	concept:personborninlocation	concept_county_york_city
concept_personnorthamerica_venezuela	concept:agentbelongstoorganization	concept_sportsleague_mls
concept_personus_access	concept:agentinvolvedwithitem	concept_buildingfeature_window
concept_personus_access	concept:subpartof	concept_company_palmsource
concept_personus_gould	concept:personborninlocation	concept_county_york_city
concept_personus_henry	concept:persondiedatage	2
concept_personus_jeremy_shockey	concept:athleteplayssportsteamposition	concept_sportsteamposition_player
concept_personus_kate_zernike	concept:worksfor	concept_musicartist_times
concept_personus_kobe_bryant	concept:athleteplayssportsteamposition	concept_sportsteamposition_player
concept_personus_media	concept:agentinvolvedwithitem	concept_buildingfeature_window
concept_personus_miller	concept:athleteinjuredhisbodypart	concept_bodypart_hands
concept_personus_miller	concept:athleteplayssportsteamposition	concept_sportsteamposition_player
concept_personus_paul_allen	concept:subpartof	concept_university_microsoft
concept_politicalparty_process	concept:subpartoforganization	concept_terroristorganization_state
concept_politicalparty_republic	concept:atdate	concept_year_n1946
concept_politicalparty_republic	concept:synonymfor	concept_country_rwanda
concept_politician_sites	concept:agentbelongstoorganization	concept_terroristorganization_state
concept_politicianus_earl_ray_tomblin	concept:personhasresidenceingeopoliticallocation	concept_stateorprovince_west_virginia
concept_politicianus_ellison	concept:personborninlocation	concept_county_york_city
concept_politicianus_fund	concept:agentbelongstoorganization	concept_terroristorganization_state
concept_politicianus_george_voinovich	concept:politicianrepresentslocation	concept_stateorprovince_ohio
concept_politicianus_henry	concept:personborninlocation	concept_county_york_city
concept_politicianus_henry	concept:personhasjobposition	concept_jobposition_leader
concept_politicianus_jim	concept:persondiedatage	2
concept_politicianus_mikhail_gorbachev	concept:personleadsorganization	concept_organization_soviet
concept_politicianus_robert	concept:persondiedatage	2
concept_politicsblog_chart	concept:agentinvolvedwithitem	concept_buildingfeature_window
concept_politicsblog_network	concept:agentcompeteswithagent	concept_university_search
concept_politicsblog_presence	concept:subpartoforganization	concept_terroristorganization_state
concept_politicsissue_age	concept:atdate	concept_date_community
concept_politicsissue_strike	concept:atdate	concept_year_n1946
concept_profession_atlantic	concept:atdate	concept_date_n1941
concept_profession_development	concept:professionusestool	concept_sportsequipment_equipment
concept_profession_number	concept:professionusestool	concept_sportsequipment_equipment
concept_profession_number	concept:professionusestool	concept_tool_tools
concept_profession_practitioners	concept:professionistypeofprofession	concept_profession_individuals
concept_profession_prices	concept:professionusestool	concept_tool_accessories
concept_profession_soldiers	concept:atdate	concept_date_n1944
concept_professor_james_reston	concept:worksfor	concept_musicartist_times
concept_professor_mark_bittman	concept:personbelongstoorganization	concept_musicartist_times
concept_programminglanguage_command	concept:atdate	concept_date_n1941
concept_programminglanguage_main	concept:atdate	concept_date_community
concept_protein_raf	concept:atdate	concept_date_n1941
concept_publication_wsaz_tv	concept:subpartof	concept_retailstore_nbc
concept_radiostation_kfai	concept:radiostationincity	concept_city_minneapolis
concept_radiostation_kgmi	concept:radiostationincity	concept_city_bellingham
concept_radiostation_kxcv	concept:radiostationincity	concept_city_maryville
concept_radiostation_kzaz	concept:radiostationincity	concept_city_bellingham
concept_radiostation_nevada	concept:companyeconomicsector	concept_economicsector_insurance_coverage
concept_radiostation_puerto_rico	concept:hasofficeincountry	concept_country___america
concept_religion_world_war_ii	concept:atdate	concept_date_n1941
concept_river_atchafalaya	concept:riveremptiesintoriver	concept_river_mississippi_river
concept_river_gila	concept:riveremptiesintoriver	concept_river_colorado_river
concept_river_gila	concept:riveremptiesintoriver	concept_river_salt_river
concept_river_illinois_river	concept:riveremptiesintoriver	concept_river_mississippi_river
concept_river_mississippi_river	concept:riveremptiesintoriver	concept_river_arkansas_river
concept_river_mississippi_river	concept:riveremptiesintoriver	concept_river_red_river
concept_river_mississippi_river	concept:riveremptiesintoriver	concept_river_wisconsin_river
concept_river_missouri_river	concept:riveremptiesintoriver	concept_river_mississippi_river
concept_river_yellowstone	concept:riveremptiesintoriver	concept_river_missouri_river
concept_roadaccidentevent_p_m__saturday	concept:atdate	concept_date_community
concept_roadaccidentevent_p_m__sunday	concept:atdate	concept_date_community
concept_room_plan	concept:subpartof	concept_weatherphenomenon_air
concept_room_properties	concept:subpartof	concept_weatherphenomenon_air
concept_scientist_mikhail_gorbachev	concept:personhasjobposition	concept_jobposition_leader
concept_scientist_mikhail_gorbachev	concept:worksfor	concept_organization_soviet
concept_scientist_yasser_arafat	concept:personhasjobposition	concept_jobposition_leader
concept_shoppingmall_columbia	concept:locationlocatedwithinlocation	concept_stateorprovince_maryland
concept_skiarea_southeastern	concept:mutualproxyfor	concept_company_missouri
concept_software_system_design	concept:subpartof	concept_hallwayitem_air
concept_software_system_works	concept:subpartof	concept_hallwayitem_air
concept_sport_badminton	concept:sportusesequipment	concept_sportsequipment_net
concept_sport_bass_fishing	concept:sportusesequipment	concept_sportsequipment_equipment
concept_sport_billiard	concept:sportusesequipment	concept_tool_accessories
concept_sport_billiards	concept:sportusesequipment	concept_tool_accessories
concept_sport_boat	concept:sportusesequipment	concept_tool_accessories
concept_sport_boating	concept:sportfansincountry	concept_country___america
concept_sport_bowling	concept:sportusesequipment	concept_sportsequipment_bowling_shoes
concept_sport_bowling	concept:sportusesequipment	concept_sportsequipment_pin
concept_sport_bowling	concept:sportusesequipment	concept_sportsequipment_pins
concept_sport_bowling	concept:sportusesequipment	concept_tool_accessories
concept_sport_boxing	concept:sportusesequipment	concept_sportsequipment_boxing_gloves
concept_sport_boxing	concept:sportusesequipment	concept_sportsequipment_equipment
concept_sport_club	concept:sportfansincountry	concept_country___america
concept_sport_college_football	concept:sportusesequipment	concept_sportsequipment_football
concept_sport_croquet	concept:sportusesequipment	concept_sportsequipment_ball
concept_sport_cycling	concept:sportschoolincountry	concept_country___america
concept_sport_dance	concept:sportschoolincountry	concept_country_uk
concept_sport_first_golf	concept:sportschoolincountry	concept_country___america
concept_sport_fitness	concept:sportfansincountry	concept_country___america
concept_sport_fly_fishing	concept:sportfansincountry	concept_country___america
concept_sport_golfing	concept:sportfansincountry	concept_country___america
concept_sport_great_golf	concept:sportusesequipment	concept_tool_accessories
concept_sport_gymnastics	concept:sportusesequipment	concept_sportsequipment_equipment
concept_sport_hunting	concept:sportfansincountry	concept_country___america
concept_sport_ice_hockey	concept:sportfansincountry	concept_country___america
concept_sport_judo	concept:sportfansincountry	concept_country_japan
concept_sport_kayak	concept:sportfansincountry	concept_country___america
concept_sport_ladies_golf	concept:sportusesequipment	concept_tool_accessories
concept_sport_major_sports	concept:sportschoolincountry	concept_country___america
concept_sport_outdoor	concept:sportusesequipment	concept_sportsequipment_equipment
concept_sport_paddling	concept:sportusesequipment	concept_sportsequipment_equipment
concept_sport_paintball	concept:sportusesequipment	concept_tool_accessories
concept_sport_pool	concept:sportusesequipment	concept_tool_accessories
concept_sport_racing	concept:sportfansincountry	concept_country___america
concept_sport_racquetball	concept:sportusesequipment	concept_sportsequipment_ball
concept_sport_rafting	concept:sportfansincountry	concept_country___america
concept_sport_rock_climbing	concept:sportusesequipment	concept_sportsequipment_equipment
concept_sport_rugby	concept:sportfansincountry	concept_country___america
concept_sport_rugby	concept:sporthassportsteamposition	concept_sportsteamposition_player
concept_sport_sailing	concept:sportschoolincountry	concept_country___america
concept_sport_scuba	concept:sportusesequipment	concept_sportsequipment_equipment
concept_sport_scuba_diving	concept:sportschoolincountry	concept_country___america
concept_sport_shooting	concept:sportusesequipment	concept_tool_accessories
concept_sport_ski	concept:sportschoolincountry	concept_country___america
concept_sport_skiing	concept:sportfansincountry	concept_country___america
concept_sport_snooker	concept:sportusesequipment	concept_tool_accessories
concept_sport_snorkeling	concept:sportusesequipment	concept_sportsequipment_equipment
concept_sport_snowboard	concept:sportfansincountry	concept_country___america
concept_sport_snowboarding	concept:sportfansincountry	concept_country___america
concept_sport_soccer	concept:sportfansincountry	concept_country___america
concept_sport_soccer	concept:sportfansincountry	concept_country_japan
concept_sport_soccer	concept:sportusesequipment	concept_sportsequipment_apparel
concept_sport_soccer	concept:sportusesequipment	concept_sportsequipment_bag
concept_sport_soccer	concept:sportusesequipment	concept_sportsequipment_ball
concept_sport_soccer	concept:sportusesequipment	concept_sportsequipment_balls
concept_sport_soccer	concept:sportusesequipment	concept_sportsequipment_cleats
concept_sport_soccer	concept:sportusesequipment	concept_sportsequipment_cones
concept_sport_soccer	concept:sportusesequipment	concept_sportsequipment_equipment
concept_sport_soccer	concept:sportusesequipment	concept_sportsequipment_football
concept_sport_soccer	concept:sportusesequipment	concept_sportsequipment_footwear
concept_sport_soccer	concept:sportusesequipment	concept_sportsequipment_gear
concept_sport_soccer	concept:sportusesequipment	concept_sportsequipment_goal
concept_sport_soccer	concept:sportusesequipment	concept_sportsequipment_goals
concept_sport_soccer	concept:sportusesequipment	concept_sportsequipment_jersey
concept_sport_soccer	concept:sportusesequipment	concept_sportsequipment_jerseys
concept_sport_soccer	concept:sportusesequipment	concept_sportsequipment_net
concept_sport_soccer	concept:sportusesequipment	concept_sportsequipment_nets
concept_sport_soccer	concept:sportusesequipment	concept_sportsequipment_shin_guards
concept_sport_soccer	concept:sportusesequipment	concept_sportsequipment_shinguards
concept_sport_soccer	concept:sportusesequipment	concept_sportsequipment_soccer_accessories
concept_sport_soccer	concept:sportusesequipment	concept_sportsequipment_soccer_ball
concept_sport_soccer	concept:sportusesequipment	concept_sportsequipment_soccer_balls
concept_sport_soccer	concept:sportusesequipment	concept_sportsequipment_soccer_cleats
concept_sport_soccer	concept:sportusesequipment	concept_sportsequipment_soccer_equipment
concept_sport_soccer	concept:sportusesequipment	concept_sportsequipment_soccer_shoes
concept_sport_soccer	concept:sportusesequipment	concept_sportsequipment_softball
concept_sport_soccer	concept:sportusesequipment	concept_sportsequipment_tennis_balls
concept_sport_soccer	concept:sportusesequipment	concept_sportsequipment_top
concept_sport_soccer	concept:sportusesequipment	concept_sportsequipment_uniforms
concept_sport_soccer	concept:sportusesequipment	concept_sportsequipment_volley_ball
concept_sport_soccer	concept:sportusesequipment	concept_visualizablething_toys
concept_sport_soccer	concept:sportusesstadium	concept_stadiumoreventvenue_wembley_stadium
concept_sport_softball	concept:sportusesequipment	concept_tool_accessories
concept_sport_sport_fishing	concept:sportfansincountry	concept_country___america
concept_sport_sports	concept:sportschoolincountry	concept_country___america
concept_sport_squash	concept:sportusesequipment	concept_tool_accessories
concept_sport_surf	concept:sportschoolincountry	concept_country___america
concept_sport_surfing	concept:sportschoolincountry	concept_country___america
concept_sport_surfing	concept:sportusesequipment	concept_tool_accessories
concept_sport_table_tennis	concept:sportusesequipment	concept_sportsequipment_balls
concept_sport_team	concept:sportusesequipment	concept_tool_accessories
concept_sport_tennis	concept:sportfansincountry	concept_country___america
concept_sport_tennis	concept:sportusesequipment	concept_software_system
concept_sport_tennis	concept:sportusesequipment	concept_sportsequipment_area
concept_sport_tennis	concept:sportusesequipment	concept_sportsequipment_bags
concept_sport_tennis	concept:sportusesequipment	concept_sportsequipment_baseball_bat
concept_sport_tennis	concept:sportusesequipment	concept_sportsequipment_baseballs
concept_sport_tennis	concept:sportusesequipment	concept_sportsequipment_bat
concept_sport_tennis	concept:sportusesequipment	concept_sportsequipment_clubs
concept_sport_tennis	concept:sportusesequipment	concept_sportsequipment_footballs
concept_sport_tennis	concept:sportusesequipment	concept_sportsequipment_golf_ball
concept_sport_tennis	concept:sportusesequipment	concept_sportsequipment_golf_club
concept_sport_tennis	concept:sportusesequipment	concept_sportsequipment_hockey_sticks
concept_sport_tennis	concept:sportusesequipment	concept_sportsequipment_part
concept_sport_tennis	concept:sportusesequipment	concept_sportsequipment_racket
concept_sport_tennis	concept:sportusesequipment	concept_sportsequipment_rope
concept_sport_tennis	concept:sportusesequipment	concept_sportsequipment_set
concept_sport_tennis	concept:sportusesequipment	concept_sportsequipment_skis
concept_sport_tennis	concept:sportusesequipment	concept_sportsequipment_sock
concept_sport_tennis	concept:sportusesequipment	concept_sportsequipment_string
concept_sport_tennis	concept:sportusesequipment	concept_sportsequipment_supplies
concept_sport_tennis	concept:sportusesequipment	concept_sportsequipment_tennis_ball
concept_sport_tennis	concept:sportusesequipment	concept_sportsequipment_tennis_racket
concept_sport_tennis	concept:sportusesequipment	concept_sportsequipment_tennis_rackets
concept_sport_tennis	concept:sportusesequipment	concept_sportsequipment_tennis_racquets
concept_sport_tennis	concept:sportusesequipment	concept_sportsequipment_tennis_shoes
concept_sport_tennis	concept:sportusesequipment	concept_tool_grips
concept_sport_tennis	concept:sportusesequipment	concept_tool_lights
concept_sport_tennis	concept:sportusesstadium	concept_stadiumoreventvenue_arthur_ashe_stadium
concept_sport_tennis	concept:sportusesstadium	concept_stadiumoreventvenue_centre_court
concept_sport_track	concept:sportschoolincountry	concept_country___america
concept_sport_triathlon	concept:sportfansincountry	concept_country___america
concept_sport_unique_golf	concept:sportusesequipment	concept_tool_accessories
concept_sport_volleyball	concept:sportusesequipment	concept_tool_accessories
concept_sport_wakeboard	concept:sportusesequipment	concept_sportsequipment_equipment
concept_sport_water_ski	concept:sportusesequipment	concept_sportsequipment_equipment
concept_sport_water_sports	concept:hobbiessuchashobbies	concept_sport_rafting
concept_sport_water_sports	concept:sportusesequipment	concept_sportsequipment_kayaks
concept_sport_winter_sports	concept:sportusesequipment	concept_sportsequipment_equipment
concept_sport_yoga	concept:sportusesequipment	concept_tool_accessories
concept_sport_youth_hockey	concept:sportschoolincountry	concept_country___america
concept_sport_youth_soccer	concept:sportfansincountry	concept_country___america
concept_sportsequipment_equipment_manufacturers	concept:subpartof	concept_hallwayitem_air
concept_sportsequipment_northwest	concept:objectfoundinscene	concept_landscapefeatures_valley
concept_sportsequipment_officials	concept:subpartof	concept_hallwayitem_air
concept_sportsequipment_rim	concept:objectfoundinscene	concept_landscapefeatures_valley
concept_sportsequipment_west	concept:objectfoundinscene	concept_landscapefeatures_valley
concept_sportsgame_n1998_wimbledon_championship	concept:sportsgamesport	concept_sport_tennis
concept_sportsgame_n2000_euro_cup	concept:sportsgamesport	concept_sport_soccer
concept_sportsgame_n2002_world_cup	concept:sportsgamesport	concept_sport_soccer
concept_sportsgame_n2005_u_s__open	concept:sportsgamesport	concept_sport_tennis
concept_sportsleague_field	concept:agentinvolvedwithitem	concept_buildingfeature_window
concept_sportsleague_mls	concept:organizationacronymhasname	concept_sportsleague_major_league_soccer
concept_sportsleague_rss	concept:agentcompeteswithagent	concept_university_search
concept_sportsteam_chicago_fire	concept:teamplayssport	concept_sport_soccer
concept_sportsteam_chivas	concept:subpartoforganization	concept_sportsleague_mls
concept_sportsteam_chivas_usa	concept:teamplaysagainstteam	concept_sportsteam_real_salt_lake
concept_sportsteam_colorado_rapids	concept:teamplaysinleague	concept_sportsleague_mls
concept_sportsteam_columbus_crew	concept:teamplaysinleague	concept_sportsleague_mls
concept_sportsteam_d_c__united	concept:teamplaysinleague	concept_sportsleague_mls
concept_sportsteam_fc_dallas	concept:teamplaysinleague	concept_sportsleague_mls
concept_sportsteam_houston_dynamo	concept:teamplaysinleague	concept_sportsleague_mls
concept_sportsteam_kansas_city_wizards	concept:teamplaysinleague	concept_sportsleague_mls
concept_sportsteam_los_angeles_galaxy	concept:teamplaysinleague	concept_sportsleague_mls
concept_sportsteam_minnesota_lynx	concept:teamhomestadium	concept_stadiumoreventvenue_target_center
concept_sportsteam_new_england_revolution	concept:teamplaysinleague	concept_sportsleague_mls
concept_sportsteam_new_york_red_bulls	concept:teamplaysincity	concept_city_east_rutherford
concept_sportsteam_new_york_red_bulls	concept:teamplaysinleague	concept_sportsleague_mls
concept_sportsteam_ny_red_bulls	concept:agentbelongstoorganization	concept_sportsleague_mls
concept_sportsteam_real_salt_lake	concept:teamplaysinleague	concept_sportsleague_mls
concept_sportsteam_red_bull_new_york	concept:agentbelongstoorganization	concept_sportsleague_mls
concept_sportsteam_san_jose_earthquakes	concept:teamplaysinleague	concept_sportsleague_mls
concept_sportsteam_seattle_sounders_fc	concept:teamplaysinleague	concept_sportsleague_mls
concept_sportsteam_sporting_kansas_city	concept:teamplaysinleague	concept_sportsleague_mls
concept_sportsteam_toronto_fc	concept:teamplaysinleague	concept_sportsleague_mls
concept_sportsteam_vancouver_whitecaps	concept:subpartoforganization	concept_sportsleague_mls
concept_sportsteam_western_washington_university	concept:teamplaysincity	concept_city_bellingham
concept_stadiumoreventvenue_target_center	concept:stadiumlocatedincity	concept_city_minneapolis
concept_stateorprovince_bayelsa	concept:statelocatedincountry	concept_country_nigeria
concept_stateorprovince_bolivar	concept:proxyfor	concept_company_missouri
concept_stateorprovince_connecticut	concept:mutualproxyfor	concept_city_bridgeport
concept_stateorprovince_facility	concept:subpartoforganization	concept_terroristorganization_state
concept_stateorprovince_florida	concept:statelocatedingeopoliticallocation	concept_country_tanzania
concept_stateorprovince_kentucky	concept:stateorprovinceisborderedbystateorprovince	concept_stateorprovince_west_virginia
concept_stateorprovince_maryland	concept:mutualproxyfor	concept_mountain_columbia
concept_stateorprovince_ohio	concept:statehascapital	concept_city_columbus
concept_stateorprovince_ontario	concept:statehascapital	concept_city_glencoe
concept_stateorprovince_store	concept:agentinvolvedwithitem	concept_buildingfeature_window
concept_stateorprovince_virginia	concept:atdate	concept_date_n1864
concept_stateorprovince_virginia	concept:atdate	concept_year_n1781
concept_stateorprovince_virginia	concept:atdate	concept_year_n1865
concept_stateorprovince_virginia	concept:mutualproxyfor	concept_city_charlottesville
concept_stateorprovince_virginia	concept:mutualproxyfor	concept_city_fredericksburg
concept_stateorprovince_virginia	concept:mutualproxyfor	concept_city_herndon
concept_stateorprovince_virginia	concept:mutualproxyfor	concept_city_newport_news_hampton_wmsburg
concept_stateorprovince_virginia	concept:mutualproxyfor	concept_city_sterling
concept_stateorprovince_virginia	concept:mutualproxyfor	concept_county_lexington
concept_stateorprovince_virginia	concept:mutualproxyfor	concept_county_williamsburg
concept_stateorprovince_west_virginia	concept:mutualproxyfor	concept_city_morgantown
concept_stateorprovince_west_virginia	concept:organizationhiredperson	concept_person_rodriguez
concept_stateorprovince_west_virginia	concept:stateorprovinceisborderedbystateorprovince	concept_stateorprovince_ohio
concept_televisionshow_aug_	concept:atdate	concept_date_community
concept_televisionshow_last_friday	concept:atdate	concept_date_community
concept_televisionshow_last_monday	concept:atdate	concept_date_community
concept_televisionshow_last_saturday	concept:atdate	concept_date_community
concept_televisionshow_last_sunday	concept:atdate	concept_date_community
concept_televisionshow_last_thursday	concept:atdate	concept_date_community
concept_televisionshow_last_wednesday	concept:atdate	concept_date_community
concept_televisionshow_monday	concept:atdate	concept_date_community
concept_televisionshow_monday_morning	concept:atdate	concept_date_community
concept_televisionshow_one_friday	concept:atdate	concept_date_community
concept_televisionshow_p_m__tuesday	concept:atdate	concept_date_community
concept_televisionshow_pearl_harbor	concept:atdate	concept_date_n1941
concept_televisionshow_saturday	concept:atdate	concept_date_community
concept_televisionshow_tuesday	concept:atdate	concept_date_community
concept_televisionshow_wednesday	concept:atdate	concept_date_community
concept_televisionshow_wednesday_morning	concept:atdate	concept_date_community
concept_televisionstation_google_maps	concept:agentinvolvedwithitem	concept_buildingfeature_window
concept_televisionstation_kaid	concept:agentbelongstoorganization	concept_company_pbs
concept_televisionstation_kare11	concept:televisionstationincity	concept_city_minneapolis
concept_televisionstation_kcfw_tv	concept:subpartof	concept_retailstore_nbc
concept_televisionstation_kcpt	concept:agentbelongstoorganization	concept_company_pbs
concept_televisionstation_kcts	concept:organizationheadquarteredincity	concept_city_seattle
concept_televisionstation_keci	concept:subpartof	concept_retailstore_nbc
concept_televisionstation_kepb	concept:televisionstationaffiliatedwith	concept_televisionnetwork_pbs
concept_televisionstation_keta_tv	concept:televisionstationaffiliatedwith	concept_televisionnetwork_pbs
concept_televisionstation_kfme	concept:subpartoforganization	concept_televisionnetwork_pbs
concept_televisionstation_khq__tv	concept:subpartof	concept_retailstore_nbc
concept_televisionstation_kiem_tv	concept:subpartof	concept_retailstore_nbc
concept_televisionstation_kjre	concept:televisionstationaffiliatedwith	concept_televisionnetwork_pbs
concept_televisionstation_kjrh	concept:subpartof	concept_retailstore_nbc
concept_televisionstation_kkco	concept:subpartof	concept_retailstore_nbc
concept_televisionstation_klcs_tv	concept:televisionstationaffiliatedwith	concept_televisionnetwork_pbs
concept_televisionstation_klru_tv	concept:televisionstationaffiliatedwith	concept_televisionnetwork_pbs
concept_televisionstation_kmtr	concept:subpartof	concept_retailstore_nbc
concept_televisionstation_knaz_tv	concept:subpartof	concept_retailstore_nbc
concept_televisionstation_kndu	concept:subpartof	concept_retailstore_nbc
concept_televisionstation_koce_tv	concept:televisionstationaffiliatedwith	concept_televisionnetwork_pbs
concept_televisionstation_koed_tv	concept:agentbelongstoorganization	concept_company_pbs
concept_televisionstation_kozj_tv	concept:televisionstationaffiliatedwith	concept_televisionnetwork_pbs
concept_televisionstation_kpts_tv	concept:televisionstationaffiliatedwith	concept_televisionnetwork_pbs
concept_televisionstation_kqed	concept:televisionstationaffiliatedwith	concept_televisionnetwork_pbs
concept_televisionstation_krmz	concept:televisionstationaffiliatedwith	concept_televisionnetwork_pbs
concept_televisionstation_kshb_tv	concept:subpartof	concept_retailstore_nbc
concept_televisionstation_ksnt	concept:subpartof	concept_retailstore_nbc
concept_televisionstation_ktvm	concept:subpartof	concept_retailstore_nbc
concept_televisionstation_kusa_tv	concept:subpartof	concept_retailstore_nbc
concept_televisionstation_kvie	concept:agentbelongstoorganization	concept_company_pbs
concept_televisionstation_kvie	concept:televisionstationaffiliatedwith	concept_televisionnetwork_pbs
concept_televisionstation_kvie	concept:televisionstationincity	concept_city_sacramento
concept_televisionstation_kwes	concept:subpartof	concept_retailstore_nbc
concept_televisionstation_kyma	concept:subpartof	concept_retailstore_nbc
concept_televisionstation_kytv	concept:subpartof	concept_retailstore_nbc
concept_televisionstation_kytv	concept:subpartoforganization	concept_televisionnetwork_nbc_universal
concept_televisionstation_wabw_tv	concept:televisionstationaffiliatedwith	concept_televisionnetwork_pbs
concept_televisionstation_waff	concept:subpartof	concept_retailstore_nbc
concept_televisionstation_waff	concept:televisionstationincity	concept_city_huntsville
concept_televisionstation_wcbb_tv	concept:televisionstationaffiliatedwith	concept_televisionnetwork_pbs
concept_televisionstation_wces_tv	concept:televisionstationaffiliatedwith	concept_televisionnetwork_pbs
concept_televisionstation_wceu	concept:televisionstationaffiliatedwith	concept_televisionnetwork_pbs
concept_televisionstation_wciq	concept:televisionstationaffiliatedwith	concept_televisionnetwork_pbs
concept_televisionstation_wcnc_tv	concept:subpartof	concept_retailstore_nbc
concept_televisionstation_wcte	concept:televisionstationaffiliatedwith	concept_televisionnetwork_pbs
concept_televisionstation_wcvw	concept:televisionstationaffiliatedwith	concept_televisionnetwork_pbs
concept_televisionstation_wdsc_tv	concept:televisionstationaffiliatedwith	concept_televisionnetwork_pbs
concept_televisionstation_wedh	concept:televisionstationaffiliatedwith	concept_televisionnetwork_pbs
concept_televisionstation_wfum	concept:subpartoforganization	concept_televisionnetwork_pbs
concept_televisionstation_whyy	concept:agentbelongstoorganization	concept_company_pbs
concept_televisionstation_wicd	concept:subpartof	concept_retailstore_nbc
concept_televisionstation_wicu_tv	concept:subpartof	concept_retailstore_nbc
concept_televisionstation_will_tv	concept:televisionstationaffiliatedwith	concept_televisionnetwork_pbs
concept_televisionstation_wjwj_tv	concept:televisionstationaffiliatedwith	concept_televisionnetwork_pbs
concept_televisionstation_wkle_tv	concept:televisionstationaffiliatedwith	concept_televisionnetwork_pbs
concept_televisionstation_wltz	concept:subpartof	concept_retailstore_nbc
concept_televisionstation_wmum_tv	concept:agentbelongstoorganization	concept_company_pbs
concept_televisionstation_wnet	concept:televisionstationaffiliatedwith	concept_televisionnetwork_pbs
concept_televisionstation_wnky	concept:subpartof	concept_retailstore_nbc
concept_televisionstation_wnyt_tv	concept:subpartof	concept_retailstore_nbc
concept_televisionstation_wpbn_tv	concept:subpartof	concept_retailstore_nbc
concept_televisionstation_wpne	concept:subpartoforganization	concept_televisionnetwork_pbs
concept_televisionstation_wpxi_tv	concept:subpartof	concept_retailstore_nbc
concept_televisionstation_wqln	concept:subpartoforganization	concept_televisionnetwork_pbs
concept_televisionstation_wtci	concept:agentbelongstoorganization	concept_company_pbs
concept_televisionstation_wtvs	concept:televisionstationaffiliatedwith	concept_televisionnetwork_pbs
concept_televisionstation_wtwc_tv	concept:subpartof	concept_retailstore_nbc
concept_televisionstation_wvan_tv	concept:televisionstationaffiliatedwith	concept_televisionnetwork_pbs
concept_televisionstation_wvia_tv	concept:televisionstationaffiliatedwith	concept_televisionnetwork_pbs
concept_televisionstation_wvla	concept:subpartof	concept_retailstore_nbc
concept_televisionstation_wvpy_tv	concept:televisionstationaffiliatedwith	concept_televisionnetwork_pbs
concept_televisionstation_wvtm_tv	concept:subpartof	concept_retailstore_nbc
concept_terroristorganization_command	concept:agentinvolvedwithitem	concept_buildingfeature_window
concept_terroristorganization_state	concept:agentactsinlocation	concept_city_azerbaijan
concept_terroristorganization_state	concept:agentcontrols	concept_buildingfeature_systems
concept_terroristorganization_state	concept:agentcontrols	concept_mlalgorithm_solutions
concept_terroristorganization_state	concept:agentcontrols	concept_museum_technologies
concept_terroristorganization_state	concept:agentcontrols	concept_politicsissue_processes
concept_terroristorganization_state	concept:agentcontrols	concept_politicsissue_requirements
concept_terroristorganization_state	concept:agentcontrols	concept_profession_agency_personnel
concept_terroristorganization_state	concept:agentcontrols	concept_profession_practitioners
concept_terroristorganization_state	concept:agentcontrols	concept_programminglanguage_procedures
concept_terroristorganization_state	concept:agentcontrols	concept_programminglanguage_process
concept_terroristorganization_state	concept:agentcontrols	concept_programminglanguage_services
concept_terroristorganization_state	concept:agentcontrols	concept_sport_initiatives
concept_terroristorganization_state	concept:agentcontrols	concept_sportsgame_leaders
concept_terroristorganization_state	concept:agentcontrols	concept_televisionshow_confederate_money
concept_terroristorganization_state	concept:agentcontrols	concept_website_partners
concept_terroristorganization_state	concept:organizationhiredperson	concept_coach_chuck_amato
concept_terroristorganization_state	concept:organizationhiredperson	concept_coach_kay_yow
concept_tradeunion_agreement	concept:agentbelongstoorganization	concept_terroristorganization_state
concept_tradeunion_article	concept:agentcompeteswithagent	concept_country_democratic_republic_of_congo
concept_transportation_start	concept:objectfoundinscene	concept_landscapefeatures_valley
concept_university_kansas_city	concept:proxyfor	concept_company_missouri
concept_university_kentucky	concept:atdate	concept_year_n1865
concept_university_message	concept:agentinvolvedwithitem	concept_buildingfeature_window
concept_university_microsoft	concept:agentcollaborateswithagent	concept_ceo_steve_ballmer
concept_university_microsoft	concept:agentcollaborateswithagent	concept_company_gates
concept_university_microsoft	concept:agentcollaborateswithagent	concept_personus_steve_ballmer
concept_university_microsoft	concept:agentcontrols	concept_website_bill
concept_university_microsoft	concept:agentcreated	concept_buildingfeature_windows
concept_university_microsoft	concept:agentcreated	concept_charactertrait_vista
concept_university_microsoft	concept:agentinvolvedwithitem	concept_vehicle_express
concept_university_microsoft	concept:agentinvolvedwithitem	concept_vehicle_visual_studio
concept_university_microsoft	concept:organizationterminatedperson	concept_scientist_balmer
concept_university_microsoft	concept:synonymfor	concept_software_excel_2007
concept_university_norway	concept:atdate	concept_date_n1941
concept_university_search	concept:agentcompeteswithagent	concept_biotechcompany_marketing
concept_university_search	concept:agentcompeteswithagent	concept_blog_access
concept_university_search	concept:agentcompeteswithagent	concept_blog_metadata
concept_university_search	concept:agentcompeteswithagent	concept_company_askjeeves
concept_university_search	concept:agentcompeteswithagent	concept_company_focus
concept_university_search	concept:agentcompeteswithagent	concept_company_power
concept_university_search	concept:agentcompeteswithagent	concept_company_rank
concept_university_search	concept:agentcompeteswithagent	concept_company_yahoo__local
concept_university_search	concept:agentcompeteswithagent	concept_televisionstation_traffic
concept_university_search	concept:agentcompeteswithagent	concept_website_clusty
concept_university_search	concept:agentcompeteswithagent	concept_website_dmoz
concept_university_search	concept:agentcompeteswithagent	concept_website_dogpile
concept_university_search	concept:agentcompeteswithagent	concept_website_gigablast
concept_university_search	concept:agentcompeteswithagent	concept_website_google__com
concept_university_search	concept:agentcompeteswithagent	concept_website_google_search
concept_university_search	concept:agentcompeteswithagent	concept_website_google_yahoo
concept_university_search	concept:agentcompeteswithagent	concept_website_googletm
concept_university_search	concept:agentcompeteswithagent	concept_website_yahoo__search_marketing
concept_vegetable_carrot	concept:agriculturalproductcutintogeometricshape	concept_geometricshape_cubes
concept_vegetable_carrots	concept:agriculturalproductcutintogeometricshape	concept_geometricshape_cubes
concept_vegetable_celery	concept:agriculturalproductcutintogeometricshape	concept_geometricshape_cubes
concept_vegetable_garlic	concept:agriculturalproductcutintogeometricshape	concept_geometricshape_cubes
concept_vegetable_ginger	concept:agriculturalproductcutintogeometricshape	concept_geometricshape_cubes
concept_vegetable_potato	concept:agriculturalproductcutintogeometricshape	concept_geometricshape_cubes
concept_vehicle_regions	concept:objectfoundinscene	concept_landscapefeatures_valley
concept_videogame_western_front	concept:atdate	concept_date_n1944
concept_virus_hostilities	concept:atdate	concept_date_n1941
concept_visualartist_games	concept:agentinvolvedwithitem	concept_buildingfeature_window
concept_visualartist_robert	concept:persondiedatage	2
concept_visualizableobject_foot	concept:objectfoundinscene	concept_landscapefeatures_valley
concept_visualizableobject_head001	concept:objectfoundinscene	concept_landscapefeatures_valley
concept_visualizableobject_map	concept:objectfoundinscene	concept_landscapefeatures_valley
concept_visualizableobject_picture	concept:objectfoundinscene	concept_landscapefeatures_valley
concept_visualizableobject_region	concept:objectfoundinscene	concept_landscapefeatures_valley
concept_visualizableobject_shirt	concept:clothingtogowithclothing	concept_clothing_apron
concept_visualizableobject_shirt	concept:clothingtogowithclothing	concept_clothing_bathing_suit
concept_visualizableobject_shirt	concept:clothingtogowithclothing	concept_clothing_black_suit
concept_visualizableobject_shirt	concept:clothingtogowithclothing	concept_clothing_breeches
concept_visualizableobject_shirt	concept:clothingtogowithclothing	concept_clothing_cords
concept_visualizableobject_shirt	concept:clothingtogowithclothing	concept_clothing_cotton
concept_visualizableobject_shirt	concept:clothingtogowithclothing	concept_clothing_coveralls
concept_visualizableobject_shirt	concept:clothingtogowithclothing	concept_clothing_cowboy_boots
concept_visualizableobject_shirt	concept:clothingtogowithclothing	concept_clothing_cowboy_hat
concept_visualizableobject_shirt	concept:clothingtogowithclothing	concept_clothing_dark_suit
concept_visualizableobject_shirt	concept:clothingtogowithclothing	concept_clothing_golf_shirt
concept_visualizableobject_shirt	concept:clothingtogowithclothing	concept_clothing_green_pants
concept_visualizableobject_shirt	concept:clothingtogowithclothing	concept_clothing_light_jacket
concept_visualizableobject_shirt	concept:clothingtogowithclothing	concept_clothing_long_sleeved_shirt
concept_visualizableobject_shirt	concept:clothingtogowithclothing	concept_clothing_mask
concept_visualizableobject_shirt	concept:clothingtogowithclothing	concept_clothing_short_sleeve
concept_visualizableobject_shirt	concept:clothingtogowithclothing	concept_clothing_striped_pants
concept_visualizableobject_shirt	concept:clothingtogowithclothing	concept_clothing_sun_hat
concept_visualizableobject_shirt	concept:clothingtogowithclothing	concept_clothing_t_shirt
concept_visualizableobject_shirt	concept:clothingtogowithclothing	concept_clothing_tight_jeans
concept_visualizableobject_shirt	concept:clothingtogowithclothing	concept_clothing_tights
concept_visualizableobject_shirt	concept:clothingtogowithclothing	concept_clothing_tuxedo
concept_visualizableobject_shirt	concept:clothingtogowithclothing	concept_clothing_white_pants
concept_visualizableobject_shirt	concept:clothingtogowithclothing	concept_clothing_windbreaker
concept_visualizableobject_shirt	concept:clothingtogowithclothing	concept_clothing_work_trousers
concept_visualizableobject_tip	concept:objectfoundinscene	concept_landscapefeatures_valley
concept_visualizableobject_top	concept:objectfoundinscene	concept_landscapefeatures_valley
concept_visualizablescene_north_bay	concept:proxyfor	concept_stateorprovince_ontario
concept_visualizablething_bedrooms	concept:subpartof	concept_weatherphenomenon_air
concept_visualizablething_front	concept:atdate	concept_date_n1944
concept_visualizablething_polenta	concept:agriculturalproductcutintogeometricshape	concept_geometricshape_squares
concept_wallitem_beginning	concept:subpartof	concept_hallwayitem_air
concept_wallitem_instrument	concept:subpartof	concept_hallwayitem_air
concept_wallitem_works	concept:subpartof	concept_hallwayitem_air
concept_weapon_arms	concept:weaponmadeincountry	concept_country_venezuela
concept_weapon_automatic_guns	concept:weaponssuchasweapons	concept_weapon_nuclear_missile
concept_weapon_average_gas	concept:weaponssuchasweapons	concept_weapon_nuclear_missile
concept_weapon_blowguns	concept:weaponssuchasweapons	concept_weapon_nuclear_missile
concept_weapon_bomb	concept:weaponmadeincountry	concept_country___america
concept_weapon_border	concept:objectfoundinscene	concept_landscapefeatures_valley
concept_weapon_boxed_collectible_knives	concept:weaponssuchasweapons	concept_weapon_nuclear_missile
concept_weapon_case	concept:objectfoundinscene	concept_landscapefeatures_valley
concept_weapon_cluster_munition	concept:weaponssuchasweapons	concept_weapon_nuclear_missile
concept_weapon_cozy_gas	concept:weaponssuchasweapons	concept_weapon_nuclear_missile
concept_weapon_current_gas	concept:weaponssuchasweapons	concept_weapon_nuclear_missile
concept_weapon_deck_guns	concept:weaponssuchasweapons	concept_weapon_nuclear_missile
concept_weapon_desert_eagle	concept:weaponssuchasweapons	concept_weapon_nuclear_missile
concept_weapon_diver_s_knives	concept:weaponssuchasweapons	concept_weapon_nuclear_missile
concept_weapon_efficient_natural_gas	concept:weaponssuchasweapons	concept_weapon_nuclear_missile
concept_weapon_energy_swords	concept:weaponssuchasweapons	concept_weapon_nuclear_missile
concept_weapon_equipment	concept:weaponmadeincountry	concept_country_iran
concept_weapon_equipment	concept:weaponssuchasweapons	concept_weapon_nuclear_missile
concept_weapon_fdt_knives	concept:weaponssuchasweapons	concept_weapon_nuclear_missile
concept_weapon_flak_cannon	concept:weaponssuchasweapons	concept_weapon_nuclear_missile
concept_weapon_fusion_cutter	concept:weaponssuchasweapons	concept_weapon_nuclear_missile
concept_weapon_future_coal	concept:weaponssuchasweapons	concept_weapon_nuclear_missile
concept_weapon_gas_canisters	concept:weaponssuchasweapons	concept_weapon_nuclear_missile
concept_weapon_highlander_sword	concept:weaponssuchasweapons	concept_weapon_nuclear_missile
concept_weapon_large_gas	concept:weaponssuchasweapons	concept_weapon_nuclear_missile
concept_weapon_larger_weapons	concept:weaponssuchasweapons	concept_weapon_nuclear_missile
concept_weapon_laser_cannons	concept:weaponssuchasweapons	concept_weapon_nuclear_missile
concept_weapon_laser_pistol	concept:weaponssuchasweapons	concept_weapon_nuclear_missile
concept_weapon_level	concept:objectfoundinscene	concept_landscapefeatures_valley
concept_weapon_local_natural_gas	concept:weaponssuchasweapons	concept_weapon_nuclear_missile
concept_weapon_many_gas	concept:weaponssuchasweapons	concept_weapon_nuclear_missile
concept_weapon_missile	concept:weaponmadeincountry	concept_country_azerbaijan
concept_weapon_n2_rifle	concept:weaponssuchasweapons	concept_weapon_nuclear_missile
concept_weapon_nazi_germany	concept:atdate	concept_date_n1941
concept_weapon_part	concept:objectfoundinscene	concept_landscapefeatures_valley
concept_weapon_pirates_sword	concept:weaponssuchasweapons	concept_weapon_nuclear_missile
concept_weapon_sentry_guns	concept:weaponssuchasweapons	concept_weapon_nuclear_missile
concept_weapon_sharp_sword	concept:weaponssuchasweapons	concept_weapon_nuclear_missile
concept_weapon_short_range_ballistic_missile	concept:weaponssuchasweapons	concept_weapon_nuclear_missile
concept_weapon_sights	concept:objectfoundinscene	concept_landscapefeatures_valley
concept_weapon_sks_rifle	concept:weaponssuchasweapons	concept_weapon_nuclear_missile
concept_weapon_smartlock_pistols	concept:weaponssuchasweapons	concept_weapon_nuclear_missile
concept_weapon_soviet_union	concept:atdate	concept_date_n1941
concept_weapon_stick_swords	concept:weaponssuchasweapons	concept_weapon_nuclear_missile
concept_weapon_sub_machineguns	concept:weaponssuchasweapons	concept_weapon_nuclear_missile
concept_weapon_taepodong_missile	concept:weaponssuchasweapons	concept_weapon_nuclear_missile
concept_weapon_twin_missile	concept:weaponssuchasweapons	concept_weapon_nuclear_missile
concept_weapon_two_new_coal	concept:weaponssuchasweapons	concept_weapon_nuclear_missile
concept_weapon_two_rocket	concept:weaponssuchasweapons	concept_weapon_nuclear_missile
concept_weapon_united_states_navy	concept:atdate	concept_date_n1941
concept_weapon_warheads	concept:weaponmadeincountry	concept_country_scandinavian_countries
concept_weapon_weapons	concept:weaponmadeincountry	concept_country_sinai
concept_weapon_weapons	concept:weaponmadeincountry	concept_country_venezuela
concept_weapon_weapons_agents	concept:weaponssuchasweapons	concept_weapon_nuclear_missile
concept_weapon_winchesters	concept:weaponssuchasweapons	concept_weapon_nuclear_missile
concept_weapon_yellowcake_uranium	concept:weaponssuchasweapons	concept_weapon_nuclear_missile
concept_weatherphenomenon_pacific	concept:atdate	concept_date_n1944
concept_website_amazon	concept:headquarteredin	concept_city_seattle
concept_website_aol_search	concept:agentcompeteswithagent	concept_university_search
concept_website_google_images	concept:agentcompeteswithagent	concept_university_search
concept_website_inktomi	concept:subpartoforganization	concept_website_yahoo_mail
concept_website_ksby	concept:subpartof	concept_retailstore_nbc
concept_website_ksee	concept:subpartof	concept_retailstore_nbc
concept_website_ktal_tv	concept:subpartof	concept_retailstore_nbc
concept_website_kwwl	concept:subpartof	concept_retailstore_nbc
concept_website_kxas_tv	concept:subpartof	concept_retailstore_nbc
concept_website_wcau	concept:subpartof	concept_retailstore_nbc
concept_website_witn_tv	concept:subpartof	concept_retailstore_nbc
concept_website_wpmi	concept:subpartof	concept_retailstore_nbc
concept_website_wwlp	concept:subpartof	concept_retailstore_nbc
concept_winery_kirkwood	concept:proxyfor	concept_company_missouri
concept_writer_profile	concept:agentinvolvedwithitem	concept_buildingfeature_window
concept_writer_walker	concept:personborninlocation	concept_county_york_city
concept_year_new	concept:atlocation	concept_attraction_louisiana
concept_year_new	concept:atlocation	concept_hospital_system
concept_year_new	concept:atlocation	concept_skiarea_case
concept_year_new	concept:atlocation	concept_stateorprovince_act
concept_year_new	concept:atlocation	concept_stateorprovince_man
concept_year_new	concept:atlocation	concept_stateorprovince_state_capital
concept_year_new	concept:atlocation	concept_visualizablething_parishes
concept_year_new	concept:atlocation	concept_zoo_moment
concept_year_new	concept:mutualproxyfor	concept_city_bar
concept_year_new	concept:mutualproxyfor	concept_city_children
concept_year_new	concept:mutualproxyfor	concept_city_princeton
concept_year_new	concept:mutualproxyfor	concept_city_seat
concept_year_new	concept:mutualproxyfor	concept_county_bedford
concept_year_new	concept:mutualproxyfor	concept_county_families
concept_year_new	concept:mutualproxyfor	concept_geopoliticallocation_option
concept_year_new	concept:mutualproxyfor	concept_geopoliticallocation_u_s__state
concept_year_new	concept:mutualproxyfor	concept_geopoliticalorganization_bottom
concept_year_new	concept:mutualproxyfor	concept_mountain_inspiration
concept_year_new	concept:mutualproxyfor	concept_mountainrange_hudson_valley
concept_year_new	concept:mutualproxyfor	concept_musicsong_moments
concept_year_new	concept:mutualproxyfor	concept_musicsong_oklahoma
concept_year_new	concept:mutualproxyfor	concept_musicsong_two_weeks
concept_year_new	concept:mutualproxyfor	concept_newspaper_destinations
concept_year_new	concept:mutualproxyfor	concept_newspaper_winner
concept_year_new	concept:mutualproxyfor	concept_politicianus_small_town
concept_year_new	concept:mutualproxyfor	concept_politicsissue_opportunity
concept_year_new	concept:mutualproxyfor	concept_politicsissue_responsibility
concept_year_new	concept:mutualproxyfor	concept_recordlabel_priority
concept_year_new	concept:mutualproxyfor	concept_retailstore_times_square
concept_year_new	concept:mutualproxyfor	concept_skiarea_combination
concept_year_new	concept:mutualproxyfor	concept_sportsteam_hampshire
concept_year_new	concept:mutualproxyfor	concept_stateorprovince_virginia
concept_year_new	concept:mutualproxyfor	concept_stateorprovince_woman
concept_year_new	concept:mutualproxyfor	concept_university_search
concept_year_new	concept:mutualproxyfor	concept_university_vermont
concept_year_new	concept:mutualproxyfor	concept_visualizablescene_birthplace
concept_year_new	concept:proxyfor	concept_bank_attorneys
concept_year_new	concept:proxyfor	concept_bank_lawyer
concept_year_new	concept:proxyfor	concept_university_attorney
concept_year_new	concept:proxyfor	concept_university_reasons
concept_year_new	concept:proxyfor	concept_visualizablething_thousand_years
concept_year_new	concept:proxyfor	concept_visualizablething_weekends
concept_year_new	concept:subpartof	concept_stateorprovince_miles
concept_televisionstation_wnin_tv	concept:subpartoforganization	concept_televisionnetwork_pbs
concept_company_pbs	concept:agentcontrols	concept_televisionstation_kvie
concept_televisionstation_wbcc_tv	concept:agentbelongstoorganization	concept_company_pbs
concept_sport_first_golf	concept:sportfansincountry	concept_country___america
concept_athlete_jason	concept:athleteinjuredhisbodypart	concept_bone_shoulder
concept_televisionstation_wkyu_tv	concept:subpartof	concept_company_pbs
concept_river_yazoo_river	concept:riveremptiesintoriver	concept_river_mississippi_river
concept_city_columbia	concept:proxyfor	concept_stateorprovince_maryland
concept_country_zimbabwe	concept:countryalsoknownas	concept_country_republic
concept_personus_steve_ballmer	concept:worksfor	concept_university_microsoft
concept_sport_volleyball	concept:sportusesequipment	concept_sportsequipment_area
concept_company_user	concept:agentinvolvedwithitem	concept_buildingfeature_windows
concept_automobilemaker_subaru	concept:producesproduct	concept_automobilemodel_subaru_forester
concept_televisionstation_kswk	concept:televisionstationaffiliatedwith	concept_televisionnetwork_pbs
concept_politicianus_mikhail_gorbachev	concept:personbelongstoorganization	concept_organization_soviet
concept_athlete_frank	concept:athleteinjuredhisbodypart	concept_braintissue_eyes
concept_weapon_course	concept:objectfoundinscene	concept_landscapefeatures_valley
concept_televisionstation_kbme_tv	concept:agentcollaborateswithagent	concept_company_pbs
concept_politician_sites	concept:agentinvolvedwithitem	concept_buildingfeature_window
concept_sport_bowling	concept:sportusesequipment	concept_sportsequipment_bag
concept_televisionstation_wosu_tv	concept:televisionstationaffiliatedwith	concept_televisionnetwork_pbs
concept_personaustralia_michael	concept:athleteinjuredhisbodypart	concept_braintissue_eyes
concept_city_district	concept:cityalsoknownas	concept_city_columbia
concept_month_march	concept:atdate	concept_date_meeting
concept_clothing_white_shirt	concept:clothingtogowithclothing	concept_clothing_tie
concept_clothing_tee	concept:clothingtogowithclothing	concept_clothing_skirt
concept_televisionstation_wosu_tv	concept:agentcollaborateswithagent	concept_company_pbs
concept_athlete_kevin	concept:persondiedatage	2
concept_automobilemaker_subaru	concept:producesproduct	concept_automobilemodel_wrx
concept_city_chantilly	concept:locationlocatedwithinlocation	concept_stateorprovince_virginia
concept_company_yahoo001	concept:agentinvolvedwithitem	concept_buildingfeature_window
concept_bank_citibank	concept:companyeconomicsector	concept_economicsector_investment
concept_sport_billiard	concept:sportusesequipment	concept_sportsequipment_balls
concept_sport_boating	concept:sportusesequipment	concept_sportsequipment_gear
concept_athlete_curtis_martin	concept:athletehomestadium	concept_stadiumoreventvenue_giants_stadium
concept_televisionstation_kusm	concept:subpartof	concept_company_pbs
concept_clothing_socks	concept:clothingtogowithclothing	concept_clothing_trousers
concept_athlete_o__j__simpson	concept:athleteplayssportsteamposition	concept_sportsteamposition_running_back
concept_fish_billfish	concept:animalsuchasfish	concept_fish_pelagics
concept_automobilemaker_chevrolet	concept:automobilemakercardealersinstateorprovince	concept_stateorprovince_virginia
concept_televisionstation_kbme_tv	concept:agentbelongstoorganization	concept_company_pbs
concept_country_darfur_region	concept:countryalsoknownas	concept_country_republic
concept_city_army	concept:atdate	concept_date_n1944
concept_city_cambridge	concept:cityliesonriver	concept_attraction_grand
concept_musicartist_session	concept:atdate	concept_date_feb_
concept_automobilemaker_ford	concept:competeswith	concept_automobilemaker_chrysler
concept_televisionstation_wkso_tv	concept:agentcollaborateswithagent	concept_company_pbs
concept_organization_lehman	concept:companyeconomicsector	concept_economicsector_investment
concept_country_gabon	concept:countryalsoknownas	concept_country_republic
concept_sport_diving	concept:sportusesequipment	concept_sportsequipment_equipment
concept_sport_sports	concept:sportusesequipment	concept_sportsequipment_football
concept_country_republic_of_lithuania	concept:synonymfor	concept_politicalparty_republic
concept_televisionstation_wqec	concept:televisionstationaffiliatedwith	concept_televisionnetwork_pbs
concept_city_morgantown	concept:citylocatedinstate	concept_stateorprovince_west_virginia
concept_clothing_trousers	concept:clothingtogowithclothing	concept_clothing_tie
concept_organization_lehman	concept:organizationacronymhasname	concept_bank_lehman_brothers
concept_televisionstation_whyy	concept:televisionstationaffiliatedwith	concept_televisionnetwork_pbs
concept_country_slovak_republic	concept:countrylocatedingeopoliticallocation	concept_country_countries
concept_clothing_skirt	concept:clothingtogowithclothing	concept_clothing_heels
concept_sport_sports	concept:sportusesequipment	concept_sportsequipment_ball
concept_person_michael002	concept:personmovedtostateorprovince	concept_stateorprovince_virginia
concept_clothing_shirts	concept:clothingtogowithclothing	concept_clothing_sweat_pants
concept_country_somalia	concept:countrylocatedingeopoliticallocation	concept_continent_africa
concept_televisionstation_krne_tv	concept:agentcollaborateswithagent	concept_company_pbs
concept_sport_sports	concept:sportfansincountry	concept_country_ireland
concept_city_tokyo	concept:atdate	concept_year_n1946
concept_televisionstation_kued	concept:agentcollaborateswithagent	concept_company_pbs
concept_bank_national	concept:bankbankincountry	concept_country_cayman_islands
concept_athlete_kevin	concept:athleteinjuredhisbodypart	concept_bodypart_hands
concept_clothing_shirts	concept:clothingtogowithclothing	concept_clothing_long_pants
concept_year_new	concept:proxyfor	concept_stateorprovince_miles
concept_country_poland	concept:countrylocatedingeopoliticallocation	concept_geopoliticallocation_destinations
concept_athlete_wallace	concept:athleteinjuredhisbodypart	concept_braintissue_eyes
concept_automobilemaker_ford	concept:producesproduct	concept_automobilemodel_ford_mustang
concept_university_microsoft	concept:agentcreated	concept_product_powerpoint
concept_nongovorganization_u_s__navy	concept:atdate	concept_date_n1942
concept_company_gates	concept:agentcontrols	concept_university_microsoft
